"x","y","cell","total","treed","untreed"
141000,1486000,323,28,26,2
149000,1486000,324,11,9,2
157000,1486000,325,1,1,0
133000,1478000,618,1,1,0
141000,1478000,619,70,70,0
149000,1478000,620,67,67,0
157000,1478000,621,12,12,0
-19000,1470000,895,18,8,10
-11000,1470000,896,33,0,33
-3000,1470000,897,21,0,21
5000,1470000,898,8,0,8
133000,1470000,914,10,10,0
141000,1470000,915,69,69,0
149000,1470000,916,52,52,0
157000,1470000,917,1,1,0
-19000,1462000,1191,26,5,21
-11000,1462000,1192,74,0,74
-3000,1462000,1193,74,0,74
5000,1462000,1194,73,3,70
13000,1462000,1195,52,23,29
21000,1462000,1196,43,24,19
29000,1462000,1197,27,7,20
37000,1462000,1198,24,6,18
45000,1462000,1199,17,10,7
53000,1462000,1200,5,2,3
133000,1462000,1210,3,2,1
141000,1462000,1211,17,15,2
149000,1462000,1212,5,4,1
157000,1462000,1213,2,2,0
-19000,1454000,1487,22,4,18
-11000,1454000,1488,73,0,73
-3000,1454000,1489,73,3,70
5000,1454000,1490,71,1,70
13000,1454000,1491,61,29,32
21000,1454000,1492,46,15,31
29000,1454000,1493,63,6,57
37000,1454000,1494,67,0,67
45000,1454000,1495,39,9,30
53000,1454000,1496,31,10,21
61000,1454000,1497,30,17,13
69000,1454000,1498,47,19,28
77000,1454000,1499,32,23,9
85000,1454000,1500,26,26,0
93000,1454000,1501,18,17,1
101000,1454000,1502,5,4,1
-19000,1446000,1783,14,3,11
-11000,1446000,1784,73,4,69
-3000,1446000,1785,76,2,74
5000,1446000,1786,73,3,70
13000,1446000,1787,69,3,66
21000,1446000,1788,57,9,48
29000,1446000,1789,54,28,26
37000,1446000,1790,75,61,14
45000,1446000,1791,27,18,9
53000,1446000,1792,29,26,3
61000,1446000,1793,46,13,33
69000,1446000,1794,71,7,64
77000,1446000,1795,54,9,45
85000,1446000,1796,30,19,11
93000,1446000,1797,42,30,12
101000,1446000,1798,64,45,19
109000,1446000,1799,52,36,16
117000,1446000,1800,40,40,0
-19000,1438000,2079,4,0,4
-11000,1438000,2080,72,1,71
-3000,1438000,2081,72,2,70
5000,1438000,2082,76,11,65
13000,1438000,2083,73,15,58
21000,1438000,2084,55,11,44
29000,1438000,2085,65,39,26
37000,1438000,2086,35,33,2
45000,1438000,2087,41,41,0
53000,1438000,2088,70,51,19
61000,1438000,2089,50,6,44
69000,1438000,2090,76,10,66
77000,1438000,2091,73,9,64
85000,1438000,2092,59,6,53
93000,1438000,2093,21,7,14
101000,1438000,2094,67,62,5
109000,1438000,2095,58,45,13
117000,1438000,2096,59,45,14
125000,1438000,2097,5,2,3
133000,1438000,2098,16,15,1
141000,1438000,2099,61,61,0
149000,1438000,2100,24,24,0
-19000,1430000,2375,11,1,10
-11000,1430000,2376,75,1,74
-3000,1430000,2377,72,0,72
5000,1430000,2378,67,0,67
13000,1430000,2379,72,3,69
21000,1430000,2380,69,7,62
29000,1430000,2381,55,11,44
37000,1430000,2382,59,15,44
45000,1430000,2383,74,14,60
53000,1430000,2384,76,12,64
61000,1430000,2385,59,12,47
69000,1430000,2386,71,12,59
77000,1430000,2387,74,15,59
85000,1430000,2388,65,22,43
93000,1430000,2389,49,39,10
101000,1430000,2390,74,73,1
109000,1430000,2391,64,48,16
117000,1430000,2392,61,32,29
125000,1430000,2393,72,64,8
133000,1430000,2394,75,75,0
141000,1430000,2395,73,73,0
149000,1430000,2396,50,50,0
157000,1430000,2397,5,5,0
-19000,1422000,2671,52,5,47
-11000,1422000,2672,65,0,65
-3000,1422000,2673,68,0,68
5000,1422000,2674,74,0,74
13000,1422000,2675,68,3,65
21000,1422000,2676,57,8,49
29000,1422000,2677,63,30,33
37000,1422000,2678,77,35,42
45000,1422000,2679,67,44,23
53000,1422000,2680,63,30,33
61000,1422000,2681,61,11,50
69000,1422000,2682,66,10,56
77000,1422000,2683,69,19,50
85000,1422000,2684,65,30,35
93000,1422000,2685,70,56,14
101000,1422000,2686,68,58,10
109000,1422000,2687,65,38,27
117000,1422000,2688,64,28,36
125000,1422000,2689,75,73,2
133000,1422000,2690,75,75,0
141000,1422000,2691,70,70,0
149000,1422000,2692,70,70,0
157000,1422000,2693,66,66,0
165000,1422000,2694,6,6,0
-19000,1414000,2967,52,5,47
-11000,1414000,2968,20,0,20
-3000,1414000,2969,58,0,58
5000,1414000,2970,78,0,78
13000,1414000,2971,72,1,71
21000,1414000,2972,49,0,49
29000,1414000,2973,54,30,24
37000,1414000,2974,73,15,58
45000,1414000,2975,67,18,49
53000,1414000,2976,71,15,56
61000,1414000,2977,64,51,13
69000,1414000,2978,64,47,17
77000,1414000,2979,65,40,25
85000,1414000,2980,72,49,23
93000,1414000,2981,71,65,6
101000,1414000,2982,72,68,4
109000,1414000,2983,54,48,6
117000,1414000,2984,60,58,2
125000,1414000,2985,43,41,2
133000,1414000,2986,60,59,1
141000,1414000,2987,64,64,0
149000,1414000,2988,80,78,2
157000,1414000,2989,70,69,1
165000,1414000,2990,26,26,0
-27000,1406000,3262,2,2,0
-19000,1406000,3263,49,8,41
-11000,1406000,3264,72,0,72
-3000,1406000,3265,74,5,69
5000,1406000,3266,74,0,74
13000,1406000,3267,75,0,75
21000,1406000,3268,69,17,52
29000,1406000,3269,69,38,31
37000,1406000,3270,67,22,45
45000,1406000,3271,65,43,22
53000,1406000,3272,77,64,13
61000,1406000,3273,70,65,5
69000,1406000,3274,63,52,11
77000,1406000,3275,63,58,5
85000,1406000,3276,71,70,1
93000,1406000,3277,70,68,2
101000,1406000,3278,70,68,2
109000,1406000,3279,75,69,6
117000,1406000,3280,69,69,0
125000,1406000,3281,63,62,1
133000,1406000,3282,70,69,1
141000,1406000,3283,71,71,0
149000,1406000,3284,74,74,0
157000,1406000,3285,73,73,0
165000,1406000,3286,63,63,0
173000,1406000,3287,45,44,1
181000,1406000,3288,38,38,0
189000,1406000,3289,21,21,0
-27000,1398000,3558,4,3,1
-19000,1398000,3559,61,9,52
-11000,1398000,3560,55,1,54
-3000,1398000,3561,72,1,71
5000,1398000,3562,73,3,70
13000,1398000,3563,70,2,68
21000,1398000,3564,69,29,40
29000,1398000,3565,65,44,21
37000,1398000,3566,63,59,4
45000,1398000,3567,70,66,4
53000,1398000,3568,68,65,3
61000,1398000,3569,68,53,15
69000,1398000,3570,40,12,28
77000,1398000,3571,60,45,15
85000,1398000,3572,75,74,1
93000,1398000,3573,76,75,1
101000,1398000,3574,70,67,3
109000,1398000,3575,75,73,2
117000,1398000,3576,71,71,0
125000,1398000,3577,73,72,1
133000,1398000,3578,72,70,2
141000,1398000,3579,73,72,1
149000,1398000,3580,72,70,2
157000,1398000,3581,73,73,0
165000,1398000,3582,71,71,0
173000,1398000,3583,73,73,0
181000,1398000,3584,77,77,0
189000,1398000,3585,65,65,0
197000,1398000,3586,30,30,0
205000,1398000,3587,19,19,0
213000,1398000,3588,3,3,0
-27000,1390000,3854,9,5,4
-19000,1390000,3855,73,9,64
-11000,1390000,3856,73,0,73
-3000,1390000,3857,73,2,71
5000,1390000,3858,71,4,67
13000,1390000,3859,71,0,71
21000,1390000,3860,70,7,63
29000,1390000,3861,65,13,52
37000,1390000,3862,68,32,36
45000,1390000,3863,63,25,38
53000,1390000,3864,46,29,17
61000,1390000,3865,36,23,13
69000,1390000,3866,68,17,51
77000,1390000,3867,69,4,65
85000,1390000,3868,66,50,16
93000,1390000,3869,65,61,4
101000,1390000,3870,71,71,0
109000,1390000,3871,72,72,0
117000,1390000,3872,77,77,0
125000,1390000,3873,69,69,0
133000,1390000,3874,73,73,0
141000,1390000,3875,72,72,0
149000,1390000,3876,67,64,3
157000,1390000,3877,70,64,6
165000,1390000,3878,73,71,2
173000,1390000,3879,75,75,0
181000,1390000,3880,80,78,2
189000,1390000,3881,76,76,0
197000,1390000,3882,73,73,0
205000,1390000,3883,75,75,0
213000,1390000,3884,70,70,0
221000,1390000,3885,41,41,0
-27000,1382000,4150,29,7,22
-19000,1382000,4151,68,4,64
-11000,1382000,4152,72,0,72
-3000,1382000,4153,75,0,75
5000,1382000,4154,71,0,71
13000,1382000,4155,68,0,68
21000,1382000,4156,70,5,65
29000,1382000,4157,68,3,65
37000,1382000,4158,56,7,49
45000,1382000,4159,67,19,48
53000,1382000,4160,47,8,39
61000,1382000,4161,20,9,11
69000,1382000,4162,32,5,27
77000,1382000,4163,44,8,36
85000,1382000,4164,64,16,48
93000,1382000,4165,66,24,42
101000,1382000,4166,54,40,14
109000,1382000,4167,59,52,7
117000,1382000,4168,74,74,0
125000,1382000,4169,67,67,0
133000,1382000,4170,72,72,0
141000,1382000,4171,74,74,0
149000,1382000,4172,73,73,0
157000,1382000,4173,71,71,0
165000,1382000,4174,72,72,0
173000,1382000,4175,80,78,2
181000,1382000,4176,74,74,0
189000,1382000,4177,71,71,0
197000,1382000,4178,74,74,0
205000,1382000,4179,73,73,0
213000,1382000,4180,73,73,0
221000,1382000,4181,57,57,0
229000,1382000,4182,3,3,0
237000,1382000,4183,3,3,0
245000,1382000,4184,7,7,0
253000,1382000,4185,72,72,0
261000,1382000,4186,67,66,1
269000,1382000,4187,41,36,5
277000,1382000,4188,43,43,0
285000,1382000,4189,15,13,2
-27000,1374000,4446,28,2,26
-19000,1374000,4447,57,1,56
-11000,1374000,4448,60,0,60
-3000,1374000,4449,76,1,75
5000,1374000,4450,71,1,70
13000,1374000,4451,73,0,73
21000,1374000,4452,73,0,73
29000,1374000,4453,65,5,60
37000,1374000,4454,62,7,55
45000,1374000,4455,60,21,39
53000,1374000,4456,21,7,14
61000,1374000,4457,3,0,3
69000,1374000,4458,21,3,18
77000,1374000,4459,49,6,43
85000,1374000,4460,52,10,42
93000,1374000,4461,69,3,66
101000,1374000,4462,33,4,29
109000,1374000,4463,45,8,37
117000,1374000,4464,69,59,10
125000,1374000,4465,72,70,2
133000,1374000,4466,72,72,0
141000,1374000,4467,73,72,1
149000,1374000,4468,70,69,1
157000,1374000,4469,57,54,3
165000,1374000,4470,63,63,0
173000,1374000,4471,80,80,0
181000,1374000,4472,70,70,0
189000,1374000,4473,72,72,0
197000,1374000,4474,72,72,0
205000,1374000,4475,73,73,0
213000,1374000,4476,70,70,0
221000,1374000,4477,78,78,0
229000,1374000,4478,73,73,0
237000,1374000,4479,69,69,0
245000,1374000,4480,74,74,0
253000,1374000,4481,71,71,0
261000,1374000,4482,67,66,1
269000,1374000,4483,68,67,1
277000,1374000,4484,59,50,9
285000,1374000,4485,65,63,2
293000,1374000,4486,31,29,2
301000,1374000,4487,7,7,0
309000,1374000,4488,2,2,0
-19000,1366000,4743,46,0,46
-11000,1366000,4744,72,0,72
-3000,1366000,4745,73,0,73
5000,1366000,4746,74,0,74
13000,1366000,4747,72,1,71
21000,1366000,4748,72,0,72
29000,1366000,4749,58,9,49
37000,1366000,4750,66,6,60
45000,1366000,4751,67,9,58
53000,1366000,4752,61,1,60
61000,1366000,4753,68,0,68
69000,1366000,4754,57,2,55
77000,1366000,4755,58,9,49
85000,1366000,4756,45,12,33
93000,1366000,4757,70,5,65
101000,1366000,4758,34,6,28
109000,1366000,4759,61,31,30
117000,1366000,4760,71,69,2
125000,1366000,4761,56,55,1
133000,1366000,4762,52,52,0
141000,1366000,4763,58,58,0
149000,1366000,4764,53,53,0
157000,1366000,4765,38,30,8
165000,1366000,4766,36,28,8
173000,1366000,4767,51,27,24
181000,1366000,4768,71,71,0
189000,1366000,4769,72,72,0
197000,1366000,4770,71,70,1
205000,1366000,4771,69,69,0
213000,1366000,4772,71,71,0
221000,1366000,4773,73,73,0
229000,1366000,4774,74,74,0
237000,1366000,4775,71,71,0
245000,1366000,4776,75,75,0
253000,1366000,4777,75,75,0
261000,1366000,4778,75,75,0
269000,1366000,4779,71,71,0
277000,1366000,4780,41,40,1
285000,1366000,4781,34,32,2
293000,1366000,4782,63,58,5
301000,1366000,4783,49,45,4
309000,1366000,4784,12,12,0
-27000,1358000,5038,14,2,12
-19000,1358000,5039,73,0,73
-11000,1358000,5040,74,0,74
-3000,1358000,5041,73,0,73
5000,1358000,5042,75,0,75
13000,1358000,5043,73,0,73
21000,1358000,5044,74,0,74
29000,1358000,5045,66,18,48
37000,1358000,5046,70,19,51
45000,1358000,5047,55,36,19
53000,1358000,5048,62,6,56
61000,1358000,5049,67,2,65
69000,1358000,5050,72,9,63
77000,1358000,5051,69,14,55
85000,1358000,5052,73,15,58
93000,1358000,5053,69,12,57
101000,1358000,5054,47,42,5
109000,1358000,5055,64,60,4
117000,1358000,5056,73,73,0
125000,1358000,5057,72,72,0
133000,1358000,5058,75,75,0
141000,1358000,5059,60,60,0
149000,1358000,5060,70,69,1
157000,1358000,5061,39,27,12
165000,1358000,5062,58,47,11
173000,1358000,5063,66,59,7
181000,1358000,5064,74,74,0
189000,1358000,5065,73,73,0
197000,1358000,5066,74,74,0
205000,1358000,5067,73,73,0
213000,1358000,5068,73,72,1
221000,1358000,5069,79,79,0
229000,1358000,5070,75,75,0
237000,1358000,5071,73,73,0
245000,1358000,5072,71,71,0
253000,1358000,5073,71,71,0
261000,1358000,5074,71,71,0
269000,1358000,5075,75,75,0
277000,1358000,5076,86,77,9
285000,1358000,5077,66,63,3
293000,1358000,5078,71,65,6
301000,1358000,5079,63,60,3
309000,1358000,5080,35,35,0
317000,1358000,5081,19,18,1
-27000,1350000,5334,8,3,5
-19000,1350000,5335,72,10,62
-11000,1350000,5336,76,0,76
-3000,1350000,5337,74,0,74
5000,1350000,5338,72,0,72
13000,1350000,5339,73,0,73
21000,1350000,5340,76,3,73
29000,1350000,5341,72,9,63
37000,1350000,5342,71,28,43
45000,1350000,5343,71,34,37
53000,1350000,5344,51,36,15
61000,1350000,5345,55,18,37
69000,1350000,5346,50,13,37
77000,1350000,5347,48,19,29
85000,1350000,5348,56,9,47
93000,1350000,5349,57,2,55
101000,1350000,5350,41,41,0
109000,1350000,5351,72,72,0
117000,1350000,5352,70,70,0
125000,1350000,5353,56,56,0
133000,1350000,5354,23,23,0
141000,1350000,5355,6,6,0
157000,1350000,5357,10,9,1
165000,1350000,5358,33,30,3
173000,1350000,5359,58,53,5
181000,1350000,5360,70,67,3
189000,1350000,5361,75,75,0
197000,1350000,5362,73,73,0
205000,1350000,5363,72,72,0
213000,1350000,5364,74,74,0
221000,1350000,5365,80,80,0
229000,1350000,5366,66,66,0
237000,1350000,5367,75,74,1
245000,1350000,5368,71,71,0
253000,1350000,5369,72,71,1
261000,1350000,5370,69,69,0
269000,1350000,5371,77,77,0
277000,1350000,5372,75,74,1
285000,1350000,5373,70,70,0
293000,1350000,5374,81,75,6
301000,1350000,5375,71,68,3
309000,1350000,5376,65,64,1
317000,1350000,5377,35,35,0
333000,1350000,5379,1,1,0
341000,1350000,5380,2,2,0
-27000,1342000,5630,2,1,1
-19000,1342000,5631,65,30,35
-11000,1342000,5632,73,6,67
-3000,1342000,5633,75,0,75
5000,1342000,5634,73,0,73
13000,1342000,5635,79,0,79
21000,1342000,5636,73,8,65
29000,1342000,5637,72,7,65
37000,1342000,5638,79,58,21
45000,1342000,5639,63,47,16
53000,1342000,5640,74,28,46
61000,1342000,5641,77,2,75
69000,1342000,5642,79,3,76
77000,1342000,5643,64,11,53
85000,1342000,5644,47,18,29
93000,1342000,5645,45,28,17
101000,1342000,5646,36,35,1
109000,1342000,5647,62,61,1
117000,1342000,5648,36,36,0
125000,1342000,5649,18,18,0
133000,1342000,5650,21,21,0
141000,1342000,5651,10,10,0
149000,1342000,5652,4,4,0
157000,1342000,5653,15,15,0
165000,1342000,5654,62,61,1
173000,1342000,5655,75,74,1
181000,1342000,5656,74,74,0
189000,1342000,5657,76,76,0
197000,1342000,5658,72,72,0
205000,1342000,5659,72,72,0
213000,1342000,5660,70,70,0
221000,1342000,5661,80,80,0
229000,1342000,5662,73,73,0
237000,1342000,5663,73,73,0
245000,1342000,5664,74,74,0
253000,1342000,5665,77,77,0
261000,1342000,5666,75,75,0
269000,1342000,5667,73,73,0
277000,1342000,5668,69,69,0
285000,1342000,5669,73,71,2
293000,1342000,5670,82,80,2
301000,1342000,5671,72,70,2
309000,1342000,5672,73,73,0
317000,1342000,5673,55,55,0
325000,1342000,5674,4,4,0
333000,1342000,5675,46,46,0
341000,1342000,5676,58,55,3
349000,1342000,5677,30,28,2
-19000,1334000,5927,59,19,40
-11000,1334000,5928,73,15,58
-3000,1334000,5929,72,5,67
5000,1334000,5930,76,0,76
13000,1334000,5931,71,5,66
21000,1334000,5932,71,9,62
29000,1334000,5933,69,11,58
37000,1334000,5934,68,57,11
45000,1334000,5935,57,47,10
53000,1334000,5936,54,11,43
61000,1334000,5937,68,4,64
69000,1334000,5938,67,10,57
77000,1334000,5939,82,5,77
85000,1334000,5940,50,28,22
93000,1334000,5941,46,45,1
101000,1334000,5942,36,36,0
109000,1334000,5943,11,9,2
133000,1334000,5946,18,18,0
141000,1334000,5947,36,36,0
149000,1334000,5948,65,64,1
157000,1334000,5949,73,72,1
165000,1334000,5950,79,77,2
173000,1334000,5951,75,73,2
181000,1334000,5952,72,72,0
189000,1334000,5953,71,71,0
197000,1334000,5954,72,72,0
205000,1334000,5955,74,74,0
213000,1334000,5956,70,68,2
221000,1334000,5957,74,73,1
229000,1334000,5958,72,72,0
237000,1334000,5959,72,72,0
245000,1334000,5960,70,69,1
253000,1334000,5961,68,67,1
261000,1334000,5962,74,74,0
269000,1334000,5963,68,68,0
277000,1334000,5964,72,70,2
285000,1334000,5965,68,62,6
293000,1334000,5966,75,65,10
301000,1334000,5967,69,69,0
309000,1334000,5968,74,71,3
317000,1334000,5969,68,68,0
325000,1334000,5970,48,47,1
333000,1334000,5971,60,55,5
341000,1334000,5972,66,55,11
349000,1334000,5973,54,49,5
357000,1334000,5974,13,10,3
-19000,1326000,6223,41,2,39
-11000,1326000,6224,73,1,72
-3000,1326000,6225,72,4,68
5000,1326000,6226,70,10,60
13000,1326000,6227,71,6,65
21000,1326000,6228,72,0,72
29000,1326000,6229,69,0,69
37000,1326000,6230,65,13,52
45000,1326000,6231,71,22,49
53000,1326000,6232,68,15,53
61000,1326000,6233,73,19,54
69000,1326000,6234,70,1,69
77000,1326000,6235,57,9,48
85000,1326000,6236,32,13,19
93000,1326000,6237,28,21,7
101000,1326000,6238,70,70,0
109000,1326000,6239,12,11,1
141000,1326000,6243,4,1,3
149000,1326000,6244,70,68,2
157000,1326000,6245,69,65,4
165000,1326000,6246,72,72,0
173000,1326000,6247,81,81,0
181000,1326000,6248,76,76,0
189000,1326000,6249,73,73,0
197000,1326000,6250,75,75,0
205000,1326000,6251,71,71,0
213000,1326000,6252,71,71,0
221000,1326000,6253,81,80,1
229000,1326000,6254,76,76,0
237000,1326000,6255,78,78,0
245000,1326000,6256,69,69,0
253000,1326000,6257,71,70,1
261000,1326000,6258,68,66,2
269000,1326000,6259,46,42,4
277000,1326000,6260,72,65,7
285000,1326000,6261,68,65,3
293000,1326000,6262,70,59,11
301000,1326000,6263,69,68,1
309000,1326000,6264,73,73,0
317000,1326000,6265,74,69,5
325000,1326000,6266,69,69,0
333000,1326000,6267,72,71,1
341000,1326000,6268,74,68,6
349000,1326000,6269,65,59,6
357000,1326000,6270,57,57,0
365000,1326000,6271,37,35,2
373000,1326000,6272,10,8,2
429000,1326000,6279,1,1,0
437000,1326000,6280,8,8,0
-19000,1318000,6519,26,6,20
-11000,1318000,6520,63,0,63
-3000,1318000,6521,68,0,68
5000,1318000,6522,71,0,71
13000,1318000,6523,72,0,72
21000,1318000,6524,67,0,67
29000,1318000,6525,62,2,60
37000,1318000,6526,70,12,58
45000,1318000,6527,75,6,69
53000,1318000,6528,74,5,69
61000,1318000,6529,72,13,59
69000,1318000,6530,53,36,17
77000,1318000,6531,50,39,11
85000,1318000,6532,54,44,10
93000,1318000,6533,60,52,8
101000,1318000,6534,67,67,0
109000,1318000,6535,62,62,0
117000,1318000,6536,61,61,0
125000,1318000,6537,63,62,1
133000,1318000,6538,60,57,3
141000,1318000,6539,53,52,1
149000,1318000,6540,73,71,2
157000,1318000,6541,71,71,0
165000,1318000,6542,74,74,0
173000,1318000,6543,72,72,0
181000,1318000,6544,72,72,0
189000,1318000,6545,74,74,0
197000,1318000,6546,72,72,0
205000,1318000,6547,73,73,0
213000,1318000,6548,74,74,0
221000,1318000,6549,78,78,0
229000,1318000,6550,72,72,0
237000,1318000,6551,70,70,0
245000,1318000,6552,70,70,0
253000,1318000,6553,69,69,0
261000,1318000,6554,78,77,1
269000,1318000,6555,75,70,5
277000,1318000,6556,62,57,5
285000,1318000,6557,44,43,1
293000,1318000,6558,68,66,2
301000,1318000,6559,69,64,5
309000,1318000,6560,73,70,3
317000,1318000,6561,70,66,4
325000,1318000,6562,70,67,3
333000,1318000,6563,76,76,0
341000,1318000,6564,74,74,0
349000,1318000,6565,68,61,7
357000,1318000,6566,70,70,0
365000,1318000,6567,70,64,6
373000,1318000,6568,31,31,0
413000,1318000,6573,10,9,1
421000,1318000,6574,44,40,4
429000,1318000,6575,50,50,0
437000,1318000,6576,30,30,0
-19000,1310000,6815,21,4,17
-11000,1310000,6816,49,1,48
-3000,1310000,6817,37,0,37
5000,1310000,6818,70,0,70
13000,1310000,6819,76,0,76
21000,1310000,6820,69,0,69
29000,1310000,6821,59,22,37
37000,1310000,6822,55,50,5
45000,1310000,6823,49,36,13
53000,1310000,6824,61,44,17
61000,1310000,6825,60,53,7
69000,1310000,6826,63,55,8
77000,1310000,6827,70,61,9
85000,1310000,6828,60,59,1
93000,1310000,6829,69,68,1
101000,1310000,6830,66,66,0
109000,1310000,6831,60,59,1
117000,1310000,6832,65,65,0
125000,1310000,6833,66,65,1
133000,1310000,6834,72,72,0
141000,1310000,6835,72,72,0
149000,1310000,6836,72,72,0
157000,1310000,6837,70,70,0
165000,1310000,6838,78,77,1
173000,1310000,6839,59,59,0
181000,1310000,6840,52,52,0
189000,1310000,6841,76,76,0
197000,1310000,6842,78,78,0
205000,1310000,6843,73,73,0
213000,1310000,6844,88,87,1
221000,1310000,6845,77,77,0
229000,1310000,6846,74,74,0
237000,1310000,6847,73,73,0
245000,1310000,6848,81,80,1
253000,1310000,6849,70,67,3
261000,1310000,6850,76,76,0
269000,1310000,6851,86,84,2
277000,1310000,6852,73,73,0
285000,1310000,6853,66,65,1
293000,1310000,6854,68,67,1
301000,1310000,6855,62,57,5
309000,1310000,6856,73,72,1
317000,1310000,6857,70,69,1
325000,1310000,6858,68,55,13
333000,1310000,6859,74,71,3
341000,1310000,6860,67,61,6
349000,1310000,6861,55,54,1
357000,1310000,6862,67,66,1
365000,1310000,6863,56,56,0
373000,1310000,6864,45,45,0
381000,1310000,6865,21,20,1
389000,1310000,6866,19,16,3
397000,1310000,6867,22,20,2
405000,1310000,6868,22,22,0
413000,1310000,6869,48,43,5
421000,1310000,6870,62,49,13
429000,1310000,6871,53,53,0
437000,1310000,6872,66,65,1
445000,1310000,6873,2,2,0
453000,1310000,6874,10,9,1
-19000,1302000,7111,29,1,28
-11000,1302000,7112,59,0,59
-3000,1302000,7113,38,0,38
5000,1302000,7114,57,0,57
13000,1302000,7115,69,2,67
21000,1302000,7116,71,8,63
29000,1302000,7117,63,55,8
37000,1302000,7118,62,60,2
45000,1302000,7119,57,45,12
53000,1302000,7120,64,46,18
61000,1302000,7121,69,51,18
69000,1302000,7122,61,52,9
77000,1302000,7123,78,78,0
85000,1302000,7124,66,61,5
93000,1302000,7125,60,57,3
101000,1302000,7126,66,61,5
109000,1302000,7127,81,80,1
117000,1302000,7128,68,65,3
125000,1302000,7129,55,53,2
133000,1302000,7130,60,58,2
141000,1302000,7131,71,69,2
149000,1302000,7132,64,63,1
157000,1302000,7133,67,67,0
165000,1302000,7134,77,77,0
173000,1302000,7135,75,75,0
181000,1302000,7136,72,72,0
189000,1302000,7137,73,73,0
197000,1302000,7138,69,68,1
205000,1302000,7139,73,73,0
213000,1302000,7140,88,85,3
221000,1302000,7141,74,74,0
229000,1302000,7142,64,64,0
237000,1302000,7143,60,60,0
245000,1302000,7144,67,67,0
253000,1302000,7145,74,74,0
261000,1302000,7146,78,78,0
269000,1302000,7147,76,74,2
277000,1302000,7148,67,67,0
285000,1302000,7149,71,69,2
293000,1302000,7150,73,72,1
301000,1302000,7151,70,50,20
309000,1302000,7152,73,57,16
317000,1302000,7153,61,58,3
325000,1302000,7154,47,47,0
333000,1302000,7155,66,66,0
341000,1302000,7156,62,59,3
349000,1302000,7157,60,54,6
357000,1302000,7158,60,59,1
365000,1302000,7159,77,73,4
373000,1302000,7160,69,65,4
381000,1302000,7161,60,54,6
389000,1302000,7162,58,48,10
397000,1302000,7163,64,48,16
405000,1302000,7164,58,55,3
413000,1302000,7165,59,42,17
421000,1302000,7166,55,31,24
429000,1302000,7167,50,35,15
437000,1302000,7168,65,63,2
445000,1302000,7169,55,49,6
453000,1302000,7170,55,46,9
461000,1302000,7171,53,44,9
469000,1302000,7172,54,54,0
477000,1302000,7173,48,48,0
485000,1302000,7174,41,41,0
493000,1302000,7175,32,30,2
-19000,1294000,7407,31,5,26
-11000,1294000,7408,60,0,60
-3000,1294000,7409,10,0,10
5000,1294000,7410,73,0,73
13000,1294000,7411,78,1,77
21000,1294000,7412,77,19,58
29000,1294000,7413,69,55,14
37000,1294000,7414,67,38,29
45000,1294000,7415,64,13,51
53000,1294000,7416,71,22,49
61000,1294000,7417,66,8,58
69000,1294000,7418,58,56,2
77000,1294000,7419,76,76,0
85000,1294000,7420,51,49,2
93000,1294000,7421,69,68,1
101000,1294000,7422,68,66,2
109000,1294000,7423,67,66,1
117000,1294000,7424,67,62,5
125000,1294000,7425,63,57,6
133000,1294000,7426,54,53,1
141000,1294000,7427,61,61,0
149000,1294000,7428,67,66,1
157000,1294000,7429,70,70,0
165000,1294000,7430,77,77,0
173000,1294000,7431,74,74,0
181000,1294000,7432,71,71,0
189000,1294000,7433,74,74,0
197000,1294000,7434,63,63,0
205000,1294000,7435,69,69,0
213000,1294000,7436,82,74,8
221000,1294000,7437,80,80,0
229000,1294000,7438,71,71,0
237000,1294000,7439,67,66,1
245000,1294000,7440,69,69,0
253000,1294000,7441,74,74,0
261000,1294000,7442,78,78,0
269000,1294000,7443,76,75,1
277000,1294000,7444,59,57,2
285000,1294000,7445,66,64,2
293000,1294000,7446,71,70,1
301000,1294000,7447,74,74,0
309000,1294000,7448,67,67,0
317000,1294000,7449,45,40,5
325000,1294000,7450,28,23,5
333000,1294000,7451,58,54,4
341000,1294000,7452,70,67,3
349000,1294000,7453,68,66,2
357000,1294000,7454,72,72,0
365000,1294000,7455,65,57,8
373000,1294000,7456,68,68,0
381000,1294000,7457,58,58,0
389000,1294000,7458,63,56,7
397000,1294000,7459,69,60,9
405000,1294000,7460,65,53,12
413000,1294000,7461,58,51,7
421000,1294000,7462,66,37,29
429000,1294000,7463,45,24,21
437000,1294000,7464,54,52,2
445000,1294000,7465,59,59,0
453000,1294000,7466,55,54,1
461000,1294000,7467,60,59,1
469000,1294000,7468,68,68,0
477000,1294000,7469,71,71,0
485000,1294000,7470,57,56,1
493000,1294000,7471,57,55,2
501000,1294000,7472,24,24,0
509000,1294000,7473,7,7,0
517000,1294000,7474,14,14,0
525000,1294000,7475,4,3,1
-19000,1286000,7703,32,4,28
-11000,1286000,7704,47,1,46
-3000,1286000,7705,56,0,56
5000,1286000,7706,72,0,72
13000,1286000,7707,73,0,73
21000,1286000,7708,74,0,74
29000,1286000,7709,71,21,50
37000,1286000,7710,65,19,46
45000,1286000,7711,70,1,69
53000,1286000,7712,72,2,70
61000,1286000,7713,59,34,25
69000,1286000,7714,61,60,1
77000,1286000,7715,72,67,5
85000,1286000,7716,70,70,0
93000,1286000,7717,68,67,1
101000,1286000,7718,72,72,0
109000,1286000,7719,78,78,0
117000,1286000,7720,73,72,1
125000,1286000,7721,69,68,1
133000,1286000,7722,56,55,1
141000,1286000,7723,59,59,0
149000,1286000,7724,70,68,2
157000,1286000,7725,68,67,1
165000,1286000,7726,66,66,0
173000,1286000,7727,67,67,0
181000,1286000,7728,56,56,0
189000,1286000,7729,57,57,0
197000,1286000,7730,55,54,1
205000,1286000,7731,63,63,0
213000,1286000,7732,72,72,0
221000,1286000,7733,58,58,0
229000,1286000,7734,63,63,0
237000,1286000,7735,67,67,0
245000,1286000,7736,66,66,0
253000,1286000,7737,72,72,0
261000,1286000,7738,81,81,0
269000,1286000,7739,79,79,0
277000,1286000,7740,79,79,0
285000,1286000,7741,78,78,0
293000,1286000,7742,69,69,0
301000,1286000,7743,73,71,2
309000,1286000,7744,71,71,0
317000,1286000,7745,66,64,2
325000,1286000,7746,59,57,2
333000,1286000,7747,70,69,1
341000,1286000,7748,59,54,5
349000,1286000,7749,64,59,5
357000,1286000,7750,70,69,1
365000,1286000,7751,72,67,5
373000,1286000,7752,69,67,2
381000,1286000,7753,59,50,9
389000,1286000,7754,68,65,3
397000,1286000,7755,71,68,3
405000,1286000,7756,73,72,1
413000,1286000,7757,74,73,1
421000,1286000,7758,64,53,11
429000,1286000,7759,46,45,1
437000,1286000,7760,65,63,2
445000,1286000,7761,57,56,1
453000,1286000,7762,71,71,0
461000,1286000,7763,73,72,1
469000,1286000,7764,70,70,0
477000,1286000,7765,67,67,0
485000,1286000,7766,73,73,0
493000,1286000,7767,70,70,0
501000,1286000,7768,76,75,1
509000,1286000,7769,26,26,0
517000,1286000,7770,9,9,0
525000,1286000,7771,19,19,0
533000,1286000,7772,1,1,0
-19000,1278000,7999,52,7,45
-11000,1278000,8000,65,0,65
-3000,1278000,8001,67,1,66
5000,1278000,8002,71,0,71
13000,1278000,8003,76,0,76
21000,1278000,8004,74,6,68
29000,1278000,8005,74,11,63
37000,1278000,8006,73,5,68
45000,1278000,8007,74,4,70
53000,1278000,8008,70,2,68
61000,1278000,8009,59,45,14
69000,1278000,8010,65,65,0
77000,1278000,8011,72,71,1
85000,1278000,8012,66,66,0
93000,1278000,8013,67,66,1
101000,1278000,8014,69,69,0
109000,1278000,8015,72,72,0
117000,1278000,8016,68,67,1
125000,1278000,8017,60,59,1
133000,1278000,8018,43,41,2
141000,1278000,8019,65,65,0
149000,1278000,8020,55,54,1
157000,1278000,8021,58,56,2
165000,1278000,8022,72,72,0
173000,1278000,8023,70,68,2
181000,1278000,8024,67,65,2
189000,1278000,8025,59,58,1
197000,1278000,8026,48,48,0
205000,1278000,8027,57,57,0
213000,1278000,8028,68,68,0
221000,1278000,8029,61,61,0
229000,1278000,8030,67,64,3
237000,1278000,8031,68,68,0
245000,1278000,8032,65,65,0
253000,1278000,8033,73,73,0
261000,1278000,8034,66,66,0
269000,1278000,8035,60,58,2
277000,1278000,8036,74,74,0
285000,1278000,8037,83,82,1
293000,1278000,8038,75,74,1
301000,1278000,8039,78,78,0
309000,1278000,8040,61,54,7
317000,1278000,8041,72,72,0
325000,1278000,8042,80,80,0
333000,1278000,8043,74,73,1
341000,1278000,8044,70,70,0
349000,1278000,8045,59,59,0
357000,1278000,8046,64,60,4
365000,1278000,8047,62,60,2
373000,1278000,8048,73,72,1
381000,1278000,8049,69,67,2
389000,1278000,8050,72,72,0
397000,1278000,8051,71,64,7
405000,1278000,8052,72,71,1
413000,1278000,8053,66,64,2
421000,1278000,8054,67,63,4
429000,1278000,8055,66,57,9
437000,1278000,8056,67,67,0
445000,1278000,8057,68,68,0
453000,1278000,8058,73,73,0
461000,1278000,8059,68,68,0
469000,1278000,8060,70,70,0
477000,1278000,8061,73,73,0
485000,1278000,8062,72,72,0
493000,1278000,8063,70,70,0
501000,1278000,8064,61,61,0
509000,1278000,8065,17,15,2
-19000,1270000,8295,65,13,52
-11000,1270000,8296,66,6,60
-3000,1270000,8297,71,2,69
5000,1270000,8298,77,6,71
13000,1270000,8299,75,5,70
21000,1270000,8300,73,32,41
29000,1270000,8301,69,49,20
37000,1270000,8302,69,29,40
45000,1270000,8303,69,6,63
53000,1270000,8304,72,7,65
61000,1270000,8305,63,37,26
69000,1270000,8306,68,66,2
77000,1270000,8307,73,73,0
85000,1270000,8308,62,62,0
93000,1270000,8309,59,58,1
101000,1270000,8310,71,71,0
109000,1270000,8311,76,76,0
117000,1270000,8312,69,69,0
125000,1270000,8313,62,62,0
133000,1270000,8314,73,73,0
141000,1270000,8315,54,54,0
149000,1270000,8316,47,47,0
157000,1270000,8317,49,48,1
165000,1270000,8318,69,69,0
173000,1270000,8319,39,33,6
181000,1270000,8320,19,18,1
189000,1270000,8321,50,48,2
197000,1270000,8322,49,49,0
205000,1270000,8323,39,38,1
213000,1270000,8324,73,73,0
221000,1270000,8325,53,53,0
229000,1270000,8326,60,58,2
237000,1270000,8327,61,58,3
245000,1270000,8328,70,70,0
253000,1270000,8329,70,70,0
261000,1270000,8330,75,75,0
269000,1270000,8331,67,67,0
277000,1270000,8332,66,66,0
285000,1270000,8333,77,77,0
293000,1270000,8334,69,69,0
301000,1270000,8335,68,68,0
309000,1270000,8336,74,74,0
317000,1270000,8337,71,71,0
325000,1270000,8338,76,73,3
333000,1270000,8339,75,75,0
341000,1270000,8340,72,72,0
349000,1270000,8341,75,75,0
357000,1270000,8342,82,82,0
365000,1270000,8343,71,71,0
373000,1270000,8344,69,67,2
381000,1270000,8345,73,69,4
389000,1270000,8346,77,69,8
397000,1270000,8347,87,76,11
405000,1270000,8348,71,68,3
413000,1270000,8349,67,61,6
421000,1270000,8350,67,59,8
429000,1270000,8351,73,70,3
437000,1270000,8352,66,66,0
445000,1270000,8353,70,70,0
453000,1270000,8354,72,71,1
461000,1270000,8355,74,74,0
469000,1270000,8356,70,70,0
477000,1270000,8357,52,52,0
485000,1270000,8358,42,42,0
493000,1270000,8359,21,21,0
501000,1270000,8360,2,2,0
-27000,1262000,8590,7,5,2
-19000,1262000,8591,77,0,77
-11000,1262000,8592,81,1,80
-3000,1262000,8593,79,0,79
5000,1262000,8594,71,0,71
13000,1262000,8595,62,0,62
21000,1262000,8596,1,0,1
29000,1262000,8597,69,17,52
37000,1262000,8598,70,3,67
45000,1262000,8599,73,0,73
53000,1262000,8600,63,16,47
61000,1262000,8601,63,62,1
69000,1262000,8602,61,58,3
77000,1262000,8603,72,72,0
85000,1262000,8604,66,66,0
93000,1262000,8605,73,71,2
101000,1262000,8606,80,80,0
109000,1262000,8607,76,76,0
117000,1262000,8608,68,68,0
125000,1262000,8609,64,64,0
133000,1262000,8610,71,71,0
141000,1262000,8611,69,69,0
149000,1262000,8612,33,33,0
157000,1262000,8613,60,60,0
165000,1262000,8614,65,63,2
173000,1262000,8615,5,5,0
181000,1262000,8616,26,25,1
189000,1262000,8617,43,38,5
197000,1262000,8618,65,62,3
205000,1262000,8619,67,66,1
213000,1262000,8620,77,77,0
221000,1262000,8621,59,59,0
229000,1262000,8622,59,58,1
237000,1262000,8623,66,65,1
245000,1262000,8624,71,71,0
253000,1262000,8625,69,69,0
261000,1262000,8626,76,76,0
269000,1262000,8627,73,73,0
277000,1262000,8628,66,66,0
285000,1262000,8629,83,79,4
293000,1262000,8630,77,76,1
301000,1262000,8631,75,75,0
309000,1262000,8632,73,73,0
317000,1262000,8633,73,73,0
325000,1262000,8634,71,71,0
333000,1262000,8635,73,67,6
341000,1262000,8636,72,58,14
349000,1262000,8637,61,48,13
357000,1262000,8638,72,72,0
365000,1262000,8639,67,66,1
373000,1262000,8640,65,64,1
381000,1262000,8641,69,68,1
389000,1262000,8642,73,71,2
397000,1262000,8643,68,67,1
405000,1262000,8644,69,69,0
413000,1262000,8645,63,63,0
421000,1262000,8646,63,63,0
429000,1262000,8647,27,27,0
437000,1262000,8648,32,32,0
445000,1262000,8649,71,69,2
453000,1262000,8650,53,53,0
461000,1262000,8651,16,16,0
469000,1262000,8652,3,3,0
-27000,1254000,8886,7,2,5
-19000,1254000,8887,73,3,70
-11000,1254000,8888,74,0,74
-3000,1254000,8889,75,0,75
5000,1254000,8890,74,0,74
13000,1254000,8891,83,4,79
21000,1254000,8892,65,0,65
29000,1254000,8893,75,3,72
37000,1254000,8894,74,0,74
45000,1254000,8895,77,2,75
53000,1254000,8896,69,53,16
61000,1254000,8897,57,55,2
69000,1254000,8898,59,59,0
77000,1254000,8899,72,72,0
85000,1254000,8900,67,67,0
93000,1254000,8901,64,64,0
101000,1254000,8902,74,73,1
109000,1254000,8903,74,72,2
117000,1254000,8904,70,70,0
125000,1254000,8905,67,66,1
133000,1254000,8906,69,68,1
141000,1254000,8907,70,70,0
149000,1254000,8908,56,56,0
157000,1254000,8909,67,67,0
165000,1254000,8910,58,58,0
173000,1254000,8911,59,59,0
181000,1254000,8912,58,57,1
189000,1254000,8913,61,61,0
197000,1254000,8914,49,47,2
205000,1254000,8915,80,80,0
213000,1254000,8916,49,48,1
221000,1254000,8917,52,52,0
229000,1254000,8918,47,47,0
237000,1254000,8919,67,67,0
245000,1254000,8920,60,60,0
253000,1254000,8921,68,68,0
261000,1254000,8922,82,82,0
269000,1254000,8923,72,72,0
277000,1254000,8924,69,69,0
285000,1254000,8925,79,76,3
293000,1254000,8926,74,74,0
301000,1254000,8927,77,77,0
309000,1254000,8928,72,72,0
317000,1254000,8929,68,67,1
325000,1254000,8930,73,73,0
333000,1254000,8931,74,70,4
341000,1254000,8932,75,67,8
349000,1254000,8933,75,73,2
357000,1254000,8934,63,63,0
365000,1254000,8935,70,68,2
373000,1254000,8936,75,74,1
381000,1254000,8937,72,72,0
389000,1254000,8938,71,71,0
397000,1254000,8939,72,72,0
405000,1254000,8940,71,71,0
413000,1254000,8941,70,69,1
421000,1254000,8942,73,73,0
429000,1254000,8943,67,67,0
437000,1254000,8944,31,31,0
445000,1254000,8945,7,7,0
-27000,1246000,9182,13,5,8
-19000,1246000,9183,75,3,72
-11000,1246000,9184,75,0,75
-3000,1246000,9185,71,0,71
5000,1246000,9186,81,0,81
13000,1246000,9187,73,0,73
21000,1246000,9188,75,2,73
29000,1246000,9189,71,0,71
37000,1246000,9190,66,0,66
45000,1246000,9191,69,6,63
53000,1246000,9192,60,55,5
61000,1246000,9193,69,67,2
69000,1246000,9194,68,68,0
77000,1246000,9195,68,68,0
85000,1246000,9196,68,68,0
93000,1246000,9197,66,66,0
101000,1246000,9198,76,76,0
109000,1246000,9199,70,70,0
117000,1246000,9200,64,64,0
125000,1246000,9201,73,73,0
133000,1246000,9202,63,63,0
141000,1246000,9203,61,59,2
149000,1246000,9204,53,53,0
157000,1246000,9205,53,51,2
165000,1246000,9206,29,28,1
173000,1246000,9207,47,47,0
181000,1246000,9208,56,56,0
189000,1246000,9209,53,53,0
197000,1246000,9210,58,55,3
205000,1246000,9211,56,50,6
213000,1246000,9212,60,59,1
221000,1246000,9213,61,61,0
229000,1246000,9214,64,63,1
237000,1246000,9215,69,69,0
245000,1246000,9216,65,65,0
253000,1246000,9217,63,63,0
261000,1246000,9218,68,68,0
269000,1246000,9219,60,60,0
277000,1246000,9220,78,78,0
285000,1246000,9221,65,65,0
293000,1246000,9222,68,68,0
301000,1246000,9223,71,71,0
309000,1246000,9224,67,67,0
317000,1246000,9225,65,65,0
325000,1246000,9226,71,71,0
333000,1246000,9227,76,76,0
341000,1246000,9228,67,66,1
349000,1246000,9229,68,68,0
357000,1246000,9230,60,60,0
365000,1246000,9231,68,68,0
373000,1246000,9232,70,69,1
381000,1246000,9233,73,73,0
389000,1246000,9234,64,64,0
397000,1246000,9235,72,72,0
405000,1246000,9236,75,75,0
413000,1246000,9237,73,73,0
421000,1246000,9238,60,60,0
429000,1246000,9239,10,10,0
-27000,1238000,9478,7,7,0
-19000,1238000,9479,75,2,73
-11000,1238000,9480,75,4,71
-3000,1238000,9481,67,0,67
5000,1238000,9482,87,0,87
13000,1238000,9483,76,3,73
21000,1238000,9484,70,1,69
29000,1238000,9485,74,0,74
37000,1238000,9486,65,0,65
45000,1238000,9487,63,21,42
53000,1238000,9488,59,57,2
61000,1238000,9489,63,62,1
69000,1238000,9490,58,56,2
77000,1238000,9491,71,71,0
85000,1238000,9492,63,63,0
93000,1238000,9493,64,64,0
101000,1238000,9494,74,74,0
109000,1238000,9495,70,70,0
117000,1238000,9496,68,68,0
125000,1238000,9497,73,73,0
133000,1238000,9498,53,52,1
141000,1238000,9499,45,45,0
149000,1238000,9500,23,23,0
157000,1238000,9501,4,4,0
165000,1238000,9502,16,16,0
173000,1238000,9503,63,59,4
181000,1238000,9504,70,70,0
189000,1238000,9505,51,51,0
197000,1238000,9506,70,70,0
205000,1238000,9507,66,63,3
213000,1238000,9508,55,55,0
221000,1238000,9509,57,57,0
229000,1238000,9510,73,73,0
237000,1238000,9511,64,64,0
245000,1238000,9512,65,65,0
253000,1238000,9513,59,59,0
261000,1238000,9514,72,72,0
269000,1238000,9515,74,74,0
277000,1238000,9516,74,74,0
285000,1238000,9517,68,68,0
293000,1238000,9518,62,61,1
301000,1238000,9519,48,43,5
309000,1238000,9520,62,59,3
317000,1238000,9521,64,63,1
325000,1238000,9522,66,66,0
333000,1238000,9523,64,64,0
341000,1238000,9524,73,73,0
349000,1238000,9525,66,65,1
357000,1238000,9526,73,73,0
365000,1238000,9527,80,80,0
373000,1238000,9528,73,73,0
381000,1238000,9529,72,72,0
389000,1238000,9530,71,71,0
397000,1238000,9531,73,73,0
405000,1238000,9532,74,74,0
413000,1238000,9533,44,44,0
421000,1238000,9534,3,3,0
-27000,1230000,9774,21,2,19
-19000,1230000,9775,73,0,73
-11000,1230000,9776,74,1,73
-3000,1230000,9777,68,1,67
5000,1230000,9778,74,0,74
13000,1230000,9779,70,0,70
21000,1230000,9780,70,3,67
29000,1230000,9781,60,0,60
37000,1230000,9782,58,0,58
45000,1230000,9783,67,22,45
53000,1230000,9784,54,50,4
61000,1230000,9785,54,51,3
69000,1230000,9786,63,61,2
77000,1230000,9787,70,67,3
85000,1230000,9788,71,59,12
93000,1230000,9789,64,64,0
101000,1230000,9790,71,71,0
109000,1230000,9791,60,60,0
117000,1230000,9792,58,58,0
125000,1230000,9793,71,71,0
133000,1230000,9794,72,72,0
141000,1230000,9795,61,61,0
149000,1230000,9796,45,45,0
157000,1230000,9797,2,2,0
165000,1230000,9798,6,6,0
173000,1230000,9799,61,60,1
181000,1230000,9800,56,56,0
189000,1230000,9801,69,68,1
197000,1230000,9802,64,64,0
205000,1230000,9803,72,72,0
213000,1230000,9804,63,62,1
221000,1230000,9805,46,46,0
229000,1230000,9806,69,69,0
237000,1230000,9807,69,69,0
245000,1230000,9808,75,75,0
253000,1230000,9809,70,70,0
261000,1230000,9810,72,71,1
269000,1230000,9811,74,74,0
277000,1230000,9812,71,71,0
285000,1230000,9813,73,70,3
293000,1230000,9814,65,65,0
301000,1230000,9815,65,65,0
309000,1230000,9816,71,67,4
317000,1230000,9817,71,67,4
325000,1230000,9818,71,69,2
333000,1230000,9819,70,70,0
341000,1230000,9820,72,72,0
349000,1230000,9821,70,69,1
357000,1230000,9822,72,72,0
365000,1230000,9823,70,70,0
373000,1230000,9824,65,65,0
381000,1230000,9825,75,75,0
389000,1230000,9826,81,79,2
397000,1230000,9827,74,74,0
405000,1230000,9828,30,30,0
-27000,1222000,10070,37,0,37
-19000,1222000,10071,74,0,74
-11000,1222000,10072,73,0,73
-3000,1222000,10073,73,0,73
5000,1222000,10074,74,2,72
13000,1222000,10075,65,7,58
21000,1222000,10076,54,27,27
29000,1222000,10077,57,18,39
37000,1222000,10078,57,11,46
45000,1222000,10079,56,47,9
53000,1222000,10080,54,52,2
61000,1222000,10081,40,38,2
69000,1222000,10082,57,57,0
77000,1222000,10083,55,55,0
85000,1222000,10084,72,72,0
93000,1222000,10085,77,72,5
101000,1222000,10086,79,77,2
109000,1222000,10087,62,59,3
117000,1222000,10088,51,47,4
125000,1222000,10089,66,62,4
133000,1222000,10090,76,72,4
141000,1222000,10091,57,57,0
149000,1222000,10092,66,66,0
157000,1222000,10093,58,58,0
165000,1222000,10094,51,51,0
173000,1222000,10095,45,44,1
181000,1222000,10096,51,48,3
189000,1222000,10097,66,66,0
197000,1222000,10098,71,70,1
205000,1222000,10099,84,84,0
213000,1222000,10100,81,80,1
221000,1222000,10101,76,76,0
229000,1222000,10102,65,65,0
237000,1222000,10103,69,67,2
245000,1222000,10104,69,69,0
253000,1222000,10105,70,70,0
261000,1222000,10106,77,77,0
269000,1222000,10107,72,72,0
277000,1222000,10108,73,73,0
285000,1222000,10109,69,68,1
293000,1222000,10110,68,66,2
301000,1222000,10111,71,71,0
309000,1222000,10112,69,69,0
317000,1222000,10113,67,67,0
325000,1222000,10114,72,71,1
333000,1222000,10115,72,72,0
341000,1222000,10116,72,70,2
349000,1222000,10117,72,71,1
357000,1222000,10118,77,77,0
365000,1222000,10119,69,68,1
373000,1222000,10120,74,74,0
381000,1222000,10121,73,73,0
389000,1222000,10122,73,73,0
397000,1222000,10123,31,31,0
621000,1222000,10151,4,4,0
629000,1222000,10152,31,31,0
637000,1222000,10153,39,39,0
645000,1222000,10154,44,44,0
653000,1222000,10155,37,37,0
661000,1222000,10156,17,17,0
-27000,1214000,10366,53,1,52
-19000,1214000,10367,70,0,70
-11000,1214000,10368,74,0,74
-3000,1214000,10369,77,0,77
5000,1214000,10370,69,0,69
13000,1214000,10371,57,17,40
21000,1214000,10372,54,39,15
29000,1214000,10373,39,35,4
37000,1214000,10374,49,38,11
45000,1214000,10375,57,42,15
53000,1214000,10376,54,52,2
61000,1214000,10377,59,59,0
69000,1214000,10378,44,43,1
77000,1214000,10379,66,66,0
85000,1214000,10380,67,66,1
93000,1214000,10381,73,73,0
101000,1214000,10382,70,59,11
109000,1214000,10383,62,61,1
117000,1214000,10384,61,61,0
125000,1214000,10385,62,62,0
133000,1214000,10386,71,71,0
141000,1214000,10387,40,40,0
149000,1214000,10388,51,51,0
157000,1214000,10389,53,53,0
165000,1214000,10390,41,41,0
173000,1214000,10391,54,54,0
181000,1214000,10392,50,50,0
189000,1214000,10393,55,55,0
197000,1214000,10394,68,68,0
205000,1214000,10395,85,80,5
213000,1214000,10396,73,71,2
221000,1214000,10397,72,72,0
229000,1214000,10398,59,58,1
237000,1214000,10399,62,58,4
245000,1214000,10400,65,64,1
253000,1214000,10401,63,61,2
261000,1214000,10402,60,50,10
269000,1214000,10403,68,62,6
277000,1214000,10404,60,46,14
285000,1214000,10405,75,74,1
293000,1214000,10406,77,76,1
301000,1214000,10407,81,70,11
309000,1214000,10408,75,65,10
317000,1214000,10409,72,70,2
325000,1214000,10410,74,73,1
333000,1214000,10411,72,72,0
341000,1214000,10412,72,72,0
349000,1214000,10413,72,67,5
357000,1214000,10414,77,76,1
365000,1214000,10415,73,73,0
373000,1214000,10416,74,74,0
381000,1214000,10417,71,71,0
389000,1214000,10418,28,28,0
605000,1214000,10445,2,2,0
613000,1214000,10446,41,41,0
621000,1214000,10447,68,68,0
629000,1214000,10448,74,74,0
637000,1214000,10449,71,71,0
645000,1214000,10450,53,53,0
653000,1214000,10451,40,40,0
661000,1214000,10452,32,32,0
-27000,1206000,10662,64,1,63
-19000,1206000,10663,74,0,74
-11000,1206000,10664,65,0,65
-3000,1206000,10665,62,0,62
5000,1206000,10666,58,0,58
13000,1206000,10667,69,13,56
21000,1206000,10668,72,18,54
29000,1206000,10669,47,26,21
37000,1206000,10670,61,51,10
45000,1206000,10671,73,67,6
53000,1206000,10672,61,51,10
61000,1206000,10673,65,62,3
69000,1206000,10674,66,65,1
77000,1206000,10675,69,69,0
85000,1206000,10676,73,73,0
93000,1206000,10677,80,78,2
101000,1206000,10678,68,67,1
109000,1206000,10679,68,67,1
117000,1206000,10680,64,64,0
125000,1206000,10681,66,66,0
133000,1206000,10682,75,75,0
141000,1206000,10683,61,61,0
149000,1206000,10684,54,54,0
157000,1206000,10685,54,53,1
165000,1206000,10686,54,53,1
173000,1206000,10687,65,65,0
181000,1206000,10688,65,65,0
189000,1206000,10689,62,62,0
197000,1206000,10690,65,64,1
205000,1206000,10691,76,76,0
213000,1206000,10692,62,62,0
221000,1206000,10693,64,64,0
229000,1206000,10694,71,70,1
237000,1206000,10695,70,70,0
245000,1206000,10696,57,51,6
253000,1206000,10697,45,45,0
261000,1206000,10698,34,31,3
269000,1206000,10699,64,63,1
277000,1206000,10700,46,38,8
285000,1206000,10701,68,65,3
293000,1206000,10702,72,72,0
301000,1206000,10703,71,71,0
309000,1206000,10704,73,73,0
317000,1206000,10705,74,72,2
325000,1206000,10706,72,69,3
333000,1206000,10707,68,67,1
341000,1206000,10708,62,61,1
349000,1206000,10709,68,62,6
357000,1206000,10710,79,79,0
365000,1206000,10711,78,78,0
373000,1206000,10712,64,64,0
381000,1206000,10713,18,18,0
605000,1206000,10741,52,52,0
613000,1206000,10742,79,79,0
621000,1206000,10743,78,78,0
629000,1206000,10744,69,69,0
637000,1206000,10745,58,58,0
645000,1206000,10746,19,19,0
-27000,1198000,10958,45,1,44
-19000,1198000,10959,72,0,72
-11000,1198000,10960,67,1,66
-3000,1198000,10961,71,5,66
5000,1198000,10962,62,0,62
13000,1198000,10963,60,25,35
21000,1198000,10964,69,42,27
29000,1198000,10965,49,38,11
37000,1198000,10966,66,66,0
45000,1198000,10967,66,66,0
53000,1198000,10968,52,46,6
61000,1198000,10969,74,50,24
69000,1198000,10970,67,67,0
77000,1198000,10971,78,78,0
85000,1198000,10972,82,82,0
93000,1198000,10973,81,80,1
101000,1198000,10974,63,63,0
109000,1198000,10975,71,71,0
117000,1198000,10976,63,63,0
125000,1198000,10977,78,78,0
133000,1198000,10978,75,75,0
141000,1198000,10979,65,65,0
149000,1198000,10980,60,60,0
157000,1198000,10981,49,49,0
165000,1198000,10982,81,81,0
173000,1198000,10983,71,71,0
181000,1198000,10984,65,65,0
189000,1198000,10985,69,69,0
197000,1198000,10986,71,71,0
205000,1198000,10987,76,75,1
213000,1198000,10988,67,63,4
221000,1198000,10989,61,60,1
229000,1198000,10990,54,52,2
237000,1198000,10991,60,53,7
245000,1198000,10992,53,45,8
253000,1198000,10993,45,44,1
261000,1198000,10994,50,49,1
269000,1198000,10995,72,69,3
277000,1198000,10996,65,63,2
285000,1198000,10997,64,63,1
293000,1198000,10998,66,66,0
301000,1198000,10999,71,71,0
309000,1198000,11000,67,67,0
317000,1198000,11001,71,64,7
325000,1198000,11002,67,67,0
333000,1198000,11003,73,71,2
341000,1198000,11004,72,72,0
349000,1198000,11005,80,80,0
357000,1198000,11006,74,74,0
365000,1198000,11007,41,41,0
373000,1198000,11008,1,1,0
589000,1198000,11035,22,22,0
597000,1198000,11036,55,55,0
605000,1198000,11037,69,69,0
613000,1198000,11038,75,75,0
621000,1198000,11039,83,83,0
629000,1198000,11040,47,47,0
637000,1198000,11041,6,6,0
-19000,1190000,11255,63,0,63
-11000,1190000,11256,68,0,68
-3000,1190000,11257,52,0,52
5000,1190000,11258,75,0,75
13000,1190000,11259,65,17,48
21000,1190000,11260,56,25,31
29000,1190000,11261,34,34,0
37000,1190000,11262,62,62,0
45000,1190000,11263,46,46,0
53000,1190000,11264,50,35,15
61000,1190000,11265,62,14,48
69000,1190000,11266,56,50,6
77000,1190000,11267,73,73,0
85000,1190000,11268,70,67,3
93000,1190000,11269,81,81,0
101000,1190000,11270,65,64,1
109000,1190000,11271,45,44,1
117000,1190000,11272,50,48,2
125000,1190000,11273,76,76,0
133000,1190000,11274,67,67,0
141000,1190000,11275,65,65,0
149000,1190000,11276,59,59,0
157000,1190000,11277,64,64,0
165000,1190000,11278,67,67,0
173000,1190000,11279,70,70,0
181000,1190000,11280,61,60,1
189000,1190000,11281,67,67,0
197000,1190000,11282,87,87,0
205000,1190000,11283,52,52,0
213000,1190000,11284,45,41,4
221000,1190000,11285,67,67,0
229000,1190000,11286,68,68,0
237000,1190000,11287,69,64,5
245000,1190000,11288,60,50,10
253000,1190000,11289,76,76,0
261000,1190000,11290,80,79,1
269000,1190000,11291,73,72,1
277000,1190000,11292,71,71,0
285000,1190000,11293,69,69,0
293000,1190000,11294,70,69,1
301000,1190000,11295,73,73,0
309000,1190000,11296,69,68,1
317000,1190000,11297,74,74,0
325000,1190000,11298,73,72,1
333000,1190000,11299,70,69,1
341000,1190000,11300,73,73,0
349000,1190000,11301,74,74,0
357000,1190000,11302,22,22,0
413000,1190000,11309,1,1,0
421000,1190000,11310,1,1,0
429000,1190000,11311,7,7,0
437000,1190000,11312,7,7,0
445000,1190000,11313,6,6,0
453000,1190000,11314,11,11,0
461000,1190000,11315,6,5,1
573000,1190000,11329,4,4,0
581000,1190000,11330,43,43,0
589000,1190000,11331,70,70,0
597000,1190000,11332,60,60,0
605000,1190000,11333,65,65,0
613000,1190000,11334,61,61,0
621000,1190000,11335,46,46,0
-27000,1182000,11550,36,3,33
-19000,1182000,11551,75,0,75
-11000,1182000,11552,67,0,67
-3000,1182000,11553,61,0,61
5000,1182000,11554,68,0,68
13000,1182000,11555,55,8,47
21000,1182000,11556,63,42,21
29000,1182000,11557,60,59,1
37000,1182000,11558,49,49,0
45000,1182000,11559,48,48,0
53000,1182000,11560,61,49,12
61000,1182000,11561,67,29,38
69000,1182000,11562,60,60,0
77000,1182000,11563,68,68,0
85000,1182000,11564,70,69,1
93000,1182000,11565,79,74,5
101000,1182000,11566,76,73,3
109000,1182000,11567,62,61,1
117000,1182000,11568,64,61,3
125000,1182000,11569,78,74,4
133000,1182000,11570,73,70,3
141000,1182000,11571,77,75,2
149000,1182000,11572,67,67,0
157000,1182000,11573,67,67,0
165000,1182000,11574,38,38,0
173000,1182000,11575,50,50,0
181000,1182000,11576,62,62,0
189000,1182000,11577,61,60,1
197000,1182000,11578,75,73,2
205000,1182000,11579,57,52,5
213000,1182000,11580,60,59,1
221000,1182000,11581,69,69,0
229000,1182000,11582,68,68,0
237000,1182000,11583,48,45,3
245000,1182000,11584,64,58,6
253000,1182000,11585,80,77,3
261000,1182000,11586,68,68,0
269000,1182000,11587,68,66,2
277000,1182000,11588,71,71,0
285000,1182000,11589,71,69,2
293000,1182000,11590,71,69,2
301000,1182000,11591,67,66,1
309000,1182000,11592,67,65,2
317000,1182000,11593,72,71,1
325000,1182000,11594,71,71,0
333000,1182000,11595,72,72,0
341000,1182000,11596,38,38,0
349000,1182000,11597,5,5,0
405000,1182000,11604,1,1,0
413000,1182000,11605,23,23,0
421000,1182000,11606,26,26,0
429000,1182000,11607,14,14,0
437000,1182000,11608,17,17,0
445000,1182000,11609,25,25,0
453000,1182000,11610,4,4,0
573000,1182000,11625,53,53,0
581000,1182000,11626,71,71,0
589000,1182000,11627,67,67,0
597000,1182000,11628,65,65,0
605000,1182000,11629,39,39,0
613000,1182000,11630,53,53,0
621000,1182000,11631,3,3,0
-27000,1174000,11846,12,0,12
-19000,1174000,11847,68,0,68
-11000,1174000,11848,75,0,75
-3000,1174000,11849,72,0,72
5000,1174000,11850,74,0,74
13000,1174000,11851,60,22,38
21000,1174000,11852,52,47,5
29000,1174000,11853,43,39,4
37000,1174000,11854,42,34,8
45000,1174000,11855,42,42,0
53000,1174000,11856,61,61,0
61000,1174000,11857,47,42,5
69000,1174000,11858,65,62,3
77000,1174000,11859,66,66,0
85000,1174000,11860,63,61,2
93000,1174000,11861,74,74,0
101000,1174000,11862,68,68,0
109000,1174000,11863,67,65,2
117000,1174000,11864,66,63,3
125000,1174000,11865,71,67,4
133000,1174000,11866,62,62,0
141000,1174000,11867,70,70,0
149000,1174000,11868,71,71,0
157000,1174000,11869,74,74,0
165000,1174000,11870,48,48,0
173000,1174000,11871,60,60,0
181000,1174000,11872,56,55,1
189000,1174000,11873,66,65,1
197000,1174000,11874,75,75,0
205000,1174000,11875,52,43,9
213000,1174000,11876,57,56,1
221000,1174000,11877,44,44,0
229000,1174000,11878,52,50,2
237000,1174000,11879,46,46,0
245000,1174000,11880,59,58,1
253000,1174000,11881,73,73,0
261000,1174000,11882,73,73,0
269000,1174000,11883,72,72,0
277000,1174000,11884,62,59,3
285000,1174000,11885,67,67,0
293000,1174000,11886,72,72,0
301000,1174000,11887,72,72,0
309000,1174000,11888,81,81,0
317000,1174000,11889,84,84,0
325000,1174000,11890,53,52,1
333000,1174000,11891,16,16,0
381000,1174000,11897,1,1,0
389000,1174000,11898,13,13,0
397000,1174000,11899,30,30,0
405000,1174000,11900,46,46,0
413000,1174000,11901,75,75,0
421000,1174000,11902,73,73,0
429000,1174000,11903,38,38,0
437000,1174000,11904,22,22,0
445000,1174000,11905,16,16,0
453000,1174000,11906,4,4,0
549000,1174000,11918,11,11,0
557000,1174000,11919,43,43,0
565000,1174000,11920,58,58,0
573000,1174000,11921,73,73,0
581000,1174000,11922,69,69,0
589000,1174000,11923,69,69,0
597000,1174000,11924,67,67,0
605000,1174000,11925,54,54,0
613000,1174000,11926,15,15,0
-19000,1166000,12143,61,1,60
-11000,1166000,12144,73,0,73
-3000,1166000,12145,70,0,70
5000,1166000,12146,72,1,71
13000,1166000,12147,59,12,47
21000,1166000,12148,47,28,19
29000,1166000,12149,44,44,0
37000,1166000,12150,47,44,3
45000,1166000,12151,36,32,4
53000,1166000,12152,22,14,8
61000,1166000,12153,52,36,16
69000,1166000,12154,57,55,2
77000,1166000,12155,69,64,5
85000,1166000,12156,48,42,6
93000,1166000,12157,64,61,3
101000,1166000,12158,57,56,1
109000,1166000,12159,60,59,1
117000,1166000,12160,63,60,3
125000,1166000,12161,63,61,2
133000,1166000,12162,67,67,0
141000,1166000,12163,68,68,0
149000,1166000,12164,72,72,0
157000,1166000,12165,55,54,1
165000,1166000,12166,32,32,0
173000,1166000,12167,52,52,0
181000,1166000,12168,56,52,4
189000,1166000,12169,58,56,2
197000,1166000,12170,60,56,4
205000,1166000,12171,55,52,3
213000,1166000,12172,52,48,4
221000,1166000,12173,62,61,1
229000,1166000,12174,63,57,6
237000,1166000,12175,45,44,1
245000,1166000,12176,63,63,0
253000,1166000,12177,73,73,0
261000,1166000,12178,66,65,1
269000,1166000,12179,64,64,0
277000,1166000,12180,61,61,0
285000,1166000,12181,65,65,0
293000,1166000,12182,73,73,0
301000,1166000,12183,70,69,1
309000,1166000,12184,81,81,0
317000,1166000,12185,65,65,0
325000,1166000,12186,49,49,0
333000,1166000,12187,7,7,0
349000,1166000,12189,1,1,0
357000,1166000,12190,6,6,0
365000,1166000,12191,26,26,0
373000,1166000,12192,35,35,0
381000,1166000,12193,60,60,0
389000,1166000,12194,75,74,1
397000,1166000,12195,75,74,1
405000,1166000,12196,73,73,0
413000,1166000,12197,76,76,0
421000,1166000,12198,63,63,0
429000,1166000,12199,27,27,0
437000,1166000,12200,27,27,0
445000,1166000,12201,4,4,0
453000,1166000,12202,1,1,0
533000,1166000,12212,1,1,0
541000,1166000,12213,21,21,0
549000,1166000,12214,63,63,0
557000,1166000,12215,72,72,0
565000,1166000,12216,83,83,0
573000,1166000,12217,72,72,0
581000,1166000,12218,71,71,0
589000,1166000,12219,70,70,0
597000,1166000,12220,75,75,0
605000,1166000,12221,40,40,0
621000,1166000,12223,15,15,0
629000,1166000,12224,12,12,0
-27000,1158000,12438,1,0,1
-19000,1158000,12439,76,0,76
-11000,1158000,12440,72,0,72
-3000,1158000,12441,68,0,68
5000,1158000,12442,72,0,72
13000,1158000,12443,67,9,58
21000,1158000,12444,58,25,33
29000,1158000,12445,47,34,13
37000,1158000,12446,43,39,4
45000,1158000,12447,53,18,35
53000,1158000,12448,44,39,5
61000,1158000,12449,64,43,21
69000,1158000,12450,61,51,10
77000,1158000,12451,72,72,0
85000,1158000,12452,51,50,1
93000,1158000,12453,66,63,3
101000,1158000,12454,67,66,1
109000,1158000,12455,67,67,0
117000,1158000,12456,64,63,1
125000,1158000,12457,63,63,0
133000,1158000,12458,65,65,0
141000,1158000,12459,69,68,1
149000,1158000,12460,43,43,0
157000,1158000,12461,31,31,0
165000,1158000,12462,44,44,0
173000,1158000,12463,60,57,3
181000,1158000,12464,54,48,6
189000,1158000,12465,64,64,0
197000,1158000,12466,53,53,0
205000,1158000,12467,62,62,0
213000,1158000,12468,71,71,0
221000,1158000,12469,61,60,1
229000,1158000,12470,47,47,0
237000,1158000,12471,66,66,0
245000,1158000,12472,66,66,0
253000,1158000,12473,64,64,0
261000,1158000,12474,69,69,0
269000,1158000,12475,59,59,0
277000,1158000,12476,70,69,1
285000,1158000,12477,80,80,0
293000,1158000,12478,67,67,0
301000,1158000,12479,70,70,0
309000,1158000,12480,76,76,0
317000,1158000,12481,71,71,0
325000,1158000,12482,74,74,0
333000,1158000,12483,64,64,0
341000,1158000,12484,55,54,1
349000,1158000,12485,57,56,1
357000,1158000,12486,74,74,0
365000,1158000,12487,73,71,2
373000,1158000,12488,75,75,0
381000,1158000,12489,78,78,0
389000,1158000,12490,75,75,0
397000,1158000,12491,75,74,1
405000,1158000,12492,65,56,9
413000,1158000,12493,75,75,0
421000,1158000,12494,19,19,0
429000,1158000,12495,15,15,0
437000,1158000,12496,3,3,0
493000,1158000,12503,7,7,0
501000,1158000,12504,41,41,0
509000,1158000,12505,50,50,0
517000,1158000,12506,11,11,0
525000,1158000,12507,7,7,0
533000,1158000,12508,62,61,1
541000,1158000,12509,24,24,0
549000,1158000,12510,15,15,0
557000,1158000,12511,20,20,0
565000,1158000,12512,45,45,0
573000,1158000,12513,72,72,0
581000,1158000,12514,71,71,0
589000,1158000,12515,76,76,0
597000,1158000,12516,82,82,0
605000,1158000,12517,14,14,0
613000,1158000,12518,31,31,0
621000,1158000,12519,54,54,0
629000,1158000,12520,62,62,0
637000,1158000,12521,51,51,0
645000,1158000,12522,31,31,0
653000,1158000,12523,16,16,0
-27000,1150000,12734,2,0,2
-19000,1150000,12735,79,0,79
-11000,1150000,12736,83,0,83
-3000,1150000,12737,75,0,75
5000,1150000,12738,72,0,72
13000,1150000,12739,75,1,74
21000,1150000,12740,58,9,49
29000,1150000,12741,50,44,6
37000,1150000,12742,54,51,3
45000,1150000,12743,46,17,29
53000,1150000,12744,61,30,31
61000,1150000,12745,58,51,7
69000,1150000,12746,60,49,11
77000,1150000,12747,61,58,3
85000,1150000,12748,69,69,0
93000,1150000,12749,60,59,1
101000,1150000,12750,67,65,2
109000,1150000,12751,66,65,1
117000,1150000,12752,66,66,0
125000,1150000,12753,55,52,3
133000,1150000,12754,71,71,0
141000,1150000,12755,60,60,0
149000,1150000,12756,50,50,0
157000,1150000,12757,50,49,1
165000,1150000,12758,64,64,0
173000,1150000,12759,62,61,1
181000,1150000,12760,42,40,2
189000,1150000,12761,49,49,0
197000,1150000,12762,53,53,0
205000,1150000,12763,63,62,1
213000,1150000,12764,56,56,0
221000,1150000,12765,67,67,0
229000,1150000,12766,65,64,1
237000,1150000,12767,70,70,0
245000,1150000,12768,76,76,0
253000,1150000,12769,85,77,8
261000,1150000,12770,80,77,3
269000,1150000,12771,76,76,0
277000,1150000,12772,75,75,0
285000,1150000,12773,72,72,0
293000,1150000,12774,71,70,1
301000,1150000,12775,73,73,0
309000,1150000,12776,75,74,1
317000,1150000,12777,74,74,0
325000,1150000,12778,73,73,0
333000,1150000,12779,72,72,0
341000,1150000,12780,73,73,0
349000,1150000,12781,73,73,0
357000,1150000,12782,72,72,0
365000,1150000,12783,74,74,0
373000,1150000,12784,74,74,0
381000,1150000,12785,68,68,0
389000,1150000,12786,68,68,0
397000,1150000,12787,75,75,0
405000,1150000,12788,67,66,1
413000,1150000,12789,64,64,0
421000,1150000,12790,11,11,0
429000,1150000,12791,12,9,3
437000,1150000,12792,2,2,0
485000,1150000,12798,10,10,0
493000,1150000,12799,67,67,0
501000,1150000,12800,73,73,0
509000,1150000,12801,76,76,0
517000,1150000,12802,73,73,0
525000,1150000,12803,64,64,0
533000,1150000,12804,79,79,0
541000,1150000,12805,56,56,0
549000,1150000,12806,47,47,0
557000,1150000,12807,46,46,0
565000,1150000,12808,50,50,0
573000,1150000,12809,85,85,0
581000,1150000,12810,68,68,0
589000,1150000,12811,81,81,0
597000,1150000,12812,74,74,0
605000,1150000,12813,37,37,0
613000,1150000,12814,70,70,0
621000,1150000,12815,67,67,0
629000,1150000,12816,72,72,0
637000,1150000,12817,67,67,0
645000,1150000,12818,72,72,0
653000,1150000,12819,65,65,0
661000,1150000,12820,35,35,0
669000,1150000,12821,3,3,0
-27000,1142000,13030,3,0,3
-19000,1142000,13031,72,0,72
-11000,1142000,13032,73,0,73
-3000,1142000,13033,79,0,79
5000,1142000,13034,78,1,77
13000,1142000,13035,77,0,77
21000,1142000,13036,54,8,46
29000,1142000,13037,49,13,36
37000,1142000,13038,57,35,22
45000,1142000,13039,56,48,8
53000,1142000,13040,64,48,16
61000,1142000,13041,67,64,3
69000,1142000,13042,66,50,16
77000,1142000,13043,67,64,3
85000,1142000,13044,75,75,0
93000,1142000,13045,67,67,0
101000,1142000,13046,77,77,0
109000,1142000,13047,76,76,0
117000,1142000,13048,68,67,1
125000,1142000,13049,62,60,2
133000,1142000,13050,68,68,0
141000,1142000,13051,67,66,1
149000,1142000,13052,62,61,1
157000,1142000,13053,65,65,0
165000,1142000,13054,64,64,0
173000,1142000,13055,64,64,0
181000,1142000,13056,56,56,0
189000,1142000,13057,57,57,0
197000,1142000,13058,58,58,0
205000,1142000,13059,48,48,0
213000,1142000,13060,68,68,0
221000,1142000,13061,72,72,0
229000,1142000,13062,72,72,0
237000,1142000,13063,76,76,0
245000,1142000,13064,69,68,1
253000,1142000,13065,82,82,0
261000,1142000,13066,72,72,0
269000,1142000,13067,68,68,0
277000,1142000,13068,68,68,0
285000,1142000,13069,71,71,0
293000,1142000,13070,69,69,0
301000,1142000,13071,74,74,0
309000,1142000,13072,83,83,0
317000,1142000,13073,79,78,1
325000,1142000,13074,80,80,0
333000,1142000,13075,78,78,0
341000,1142000,13076,79,79,0
349000,1142000,13077,78,78,0
357000,1142000,13078,72,72,0
365000,1142000,13079,74,74,0
373000,1142000,13080,70,70,0
381000,1142000,13081,67,66,1
389000,1142000,13082,72,72,0
397000,1142000,13083,76,76,0
405000,1142000,13084,74,74,0
413000,1142000,13085,49,49,0
421000,1142000,13086,55,55,0
429000,1142000,13087,47,47,0
437000,1142000,13088,43,42,1
445000,1142000,13089,2,2,0
461000,1142000,13091,15,15,0
469000,1142000,13092,36,36,0
477000,1142000,13093,48,48,0
485000,1142000,13094,68,68,0
493000,1142000,13095,82,82,0
501000,1142000,13096,70,70,0
509000,1142000,13097,70,70,0
517000,1142000,13098,73,73,0
525000,1142000,13099,74,74,0
533000,1142000,13100,73,73,0
541000,1142000,13101,69,69,0
549000,1142000,13102,74,74,0
557000,1142000,13103,73,73,0
565000,1142000,13104,80,80,0
573000,1142000,13105,85,85,0
581000,1142000,13106,71,71,0
589000,1142000,13107,83,83,0
597000,1142000,13108,69,69,0
605000,1142000,13109,74,74,0
613000,1142000,13110,76,76,0
621000,1142000,13111,79,79,0
629000,1142000,13112,77,77,0
637000,1142000,13113,78,78,0
645000,1142000,13114,76,75,1
653000,1142000,13115,78,78,0
661000,1142000,13116,71,71,0
669000,1142000,13117,31,31,0
-27000,1134000,13326,19,0,19
-19000,1134000,13327,80,0,80
-11000,1134000,13328,77,0,77
-3000,1134000,13329,80,0,80
5000,1134000,13330,76,0,76
13000,1134000,13331,62,0,62
21000,1134000,13332,68,1,67
29000,1134000,13333,70,2,68
37000,1134000,13334,55,27,28
45000,1134000,13335,63,28,35
53000,1134000,13336,64,60,4
61000,1134000,13337,68,62,6
69000,1134000,13338,68,52,16
77000,1134000,13339,64,57,7
85000,1134000,13340,72,72,0
93000,1134000,13341,72,72,0
101000,1134000,13342,72,72,0
109000,1134000,13343,71,70,1
117000,1134000,13344,66,65,1
125000,1134000,13345,64,63,1
133000,1134000,13346,58,58,0
141000,1134000,13347,67,67,0
149000,1134000,13348,63,61,2
157000,1134000,13349,69,67,2
165000,1134000,13350,57,53,4
173000,1134000,13351,71,71,0
181000,1134000,13352,61,60,1
189000,1134000,13353,33,32,1
197000,1134000,13354,1,1,0
213000,1134000,13356,48,48,0
221000,1134000,13357,74,74,0
229000,1134000,13358,72,71,1
237000,1134000,13359,74,73,1
245000,1134000,13360,76,76,0
253000,1134000,13361,73,72,1
261000,1134000,13362,74,74,0
269000,1134000,13363,70,60,10
277000,1134000,13364,74,73,1
285000,1134000,13365,71,71,0
293000,1134000,13366,70,70,0
301000,1134000,13367,75,75,0
309000,1134000,13368,77,77,0
317000,1134000,13369,74,74,0
325000,1134000,13370,72,72,0
333000,1134000,13371,69,69,0
341000,1134000,13372,71,71,0
349000,1134000,13373,72,72,0
357000,1134000,13374,77,77,0
365000,1134000,13375,76,62,14
373000,1134000,13376,80,79,1
381000,1134000,13377,76,76,0
389000,1134000,13378,76,76,0
397000,1134000,13379,77,77,0
405000,1134000,13380,77,76,1
413000,1134000,13381,75,75,0
421000,1134000,13382,78,76,2
429000,1134000,13383,75,75,0
437000,1134000,13384,71,70,1
445000,1134000,13385,72,72,0
453000,1134000,13386,55,55,0
461000,1134000,13387,69,69,0
469000,1134000,13388,72,72,0
477000,1134000,13389,71,71,0
485000,1134000,13390,74,74,0
493000,1134000,13391,80,80,0
501000,1134000,13392,86,86,0
509000,1134000,13393,73,73,0
517000,1134000,13394,63,63,0
525000,1134000,13395,74,74,0
533000,1134000,13396,71,71,0
541000,1134000,13397,70,70,0
549000,1134000,13398,71,71,0
557000,1134000,13399,71,71,0
565000,1134000,13400,79,79,0
573000,1134000,13401,72,72,0
581000,1134000,13402,76,76,0
589000,1134000,13403,80,80,0
597000,1134000,13404,72,72,0
605000,1134000,13405,73,73,0
613000,1134000,13406,73,73,0
621000,1134000,13407,74,74,0
629000,1134000,13408,72,72,0
637000,1134000,13409,69,69,0
645000,1134000,13410,73,73,0
653000,1134000,13411,69,69,0
661000,1134000,13412,72,71,1
669000,1134000,13413,63,63,0
677000,1134000,13414,7,7,0
837000,1134000,13434,2,2,0
845000,1134000,13435,31,31,0
853000,1134000,13436,38,38,0
861000,1134000,13437,35,35,0
869000,1134000,13438,16,16,0
-27000,1126000,13622,26,0,26
-19000,1126000,13623,71,0,71
-11000,1126000,13624,66,0,66
-3000,1126000,13625,77,0,77
5000,1126000,13626,72,0,72
13000,1126000,13627,71,0,71
21000,1126000,13628,66,2,64
29000,1126000,13629,60,5,55
37000,1126000,13630,57,13,44
45000,1126000,13631,47,34,13
53000,1126000,13632,51,34,17
61000,1126000,13633,54,28,26
69000,1126000,13634,49,49,0
77000,1126000,13635,66,65,1
85000,1126000,13636,81,81,0
93000,1126000,13637,72,72,0
101000,1126000,13638,73,73,0
109000,1126000,13639,69,61,8
117000,1126000,13640,61,59,2
125000,1126000,13641,69,69,0
133000,1126000,13642,69,69,0
141000,1126000,13643,68,68,0
149000,1126000,13644,63,62,1
157000,1126000,13645,64,64,0
165000,1126000,13646,71,68,3
173000,1126000,13647,71,71,0
181000,1126000,13648,64,63,1
189000,1126000,13649,56,53,3
213000,1126000,13652,63,60,3
221000,1126000,13653,81,81,0
229000,1126000,13654,83,82,1
237000,1126000,13655,83,83,0
245000,1126000,13656,75,75,0
253000,1126000,13657,68,68,0
261000,1126000,13658,66,66,0
269000,1126000,13659,62,62,0
277000,1126000,13660,72,72,0
285000,1126000,13661,69,69,0
293000,1126000,13662,74,74,0
301000,1126000,13663,75,75,0
309000,1126000,13664,76,76,0
317000,1126000,13665,75,75,0
325000,1126000,13666,72,72,0
333000,1126000,13667,74,74,0
341000,1126000,13668,72,72,0
349000,1126000,13669,70,70,0
357000,1126000,13670,72,72,0
365000,1126000,13671,67,65,2
373000,1126000,13672,74,74,0
381000,1126000,13673,75,75,0
389000,1126000,13674,70,70,0
397000,1126000,13675,72,72,0
405000,1126000,13676,70,70,0
413000,1126000,13677,74,74,0
421000,1126000,13678,75,74,1
429000,1126000,13679,72,71,1
437000,1126000,13680,75,74,1
445000,1126000,13681,77,77,0
453000,1126000,13682,73,73,0
461000,1126000,13683,72,72,0
469000,1126000,13684,74,74,0
477000,1126000,13685,73,73,0
485000,1126000,13686,73,73,0
493000,1126000,13687,71,71,0
501000,1126000,13688,80,80,0
509000,1126000,13689,81,81,0
517000,1126000,13690,55,55,0
525000,1126000,13691,82,82,0
533000,1126000,13692,76,75,1
541000,1126000,13693,74,74,0
549000,1126000,13694,71,71,0
557000,1126000,13695,81,81,0
565000,1126000,13696,73,73,0
573000,1126000,13697,70,70,0
581000,1126000,13698,80,80,0
589000,1126000,13699,72,72,0
597000,1126000,13700,72,72,0
605000,1126000,13701,72,72,0
613000,1126000,13702,72,72,0
621000,1126000,13703,67,67,0
629000,1126000,13704,71,71,0
637000,1126000,13705,70,70,0
645000,1126000,13706,67,67,0
653000,1126000,13707,74,74,0
661000,1126000,13708,70,70,0
669000,1126000,13709,69,69,0
677000,1126000,13710,34,34,0
773000,1126000,13722,15,15,0
781000,1126000,13723,33,33,0
789000,1126000,13724,29,29,0
797000,1126000,13725,62,62,0
805000,1126000,13726,46,46,0
813000,1126000,13727,35,35,0
821000,1126000,13728,31,31,0
829000,1126000,13729,40,40,0
837000,1126000,13730,62,62,0
845000,1126000,13731,73,73,0
853000,1126000,13732,73,73,0
861000,1126000,13733,66,66,0
-27000,1118000,13918,44,0,44
-19000,1118000,13919,75,0,75
-11000,1118000,13920,58,0,58
-3000,1118000,13921,77,0,77
5000,1118000,13922,72,0,72
13000,1118000,13923,69,0,69
21000,1118000,13924,63,2,61
29000,1118000,13925,62,1,61
37000,1118000,13926,69,2,67
45000,1118000,13927,59,10,49
53000,1118000,13928,52,32,20
61000,1118000,13929,47,45,2
69000,1118000,13930,55,54,1
77000,1118000,13931,71,71,0
85000,1118000,13932,79,79,0
93000,1118000,13933,67,66,1
101000,1118000,13934,70,70,0
109000,1118000,13935,67,67,0
117000,1118000,13936,72,72,0
125000,1118000,13937,66,66,0
133000,1118000,13938,72,72,0
141000,1118000,13939,71,71,0
149000,1118000,13940,54,47,7
157000,1118000,13941,65,65,0
165000,1118000,13942,72,72,0
173000,1118000,13943,69,68,1
181000,1118000,13944,56,56,0
189000,1118000,13945,61,59,2
197000,1118000,13946,12,11,1
205000,1118000,13947,1,1,0
213000,1118000,13948,43,38,5
221000,1118000,13949,71,70,1
229000,1118000,13950,71,68,3
237000,1118000,13951,68,68,0
245000,1118000,13952,82,80,2
253000,1118000,13953,71,69,2
261000,1118000,13954,82,82,0
269000,1118000,13955,74,74,0
277000,1118000,13956,66,66,0
285000,1118000,13957,64,64,0
293000,1118000,13958,74,74,0
301000,1118000,13959,75,75,0
309000,1118000,13960,75,75,0
317000,1118000,13961,74,74,0
325000,1118000,13962,72,72,0
333000,1118000,13963,74,74,0
341000,1118000,13964,70,70,0
349000,1118000,13965,68,67,1
357000,1118000,13966,69,69,0
365000,1118000,13967,62,62,0
373000,1118000,13968,70,70,0
381000,1118000,13969,74,74,0
389000,1118000,13970,70,70,0
397000,1118000,13971,74,72,2
405000,1118000,13972,74,74,0
413000,1118000,13973,72,72,0
421000,1118000,13974,74,74,0
429000,1118000,13975,74,74,0
437000,1118000,13976,73,72,1
445000,1118000,13977,73,73,0
453000,1118000,13978,74,74,0
461000,1118000,13979,78,78,0
469000,1118000,13980,66,66,0
477000,1118000,13981,69,69,0
485000,1118000,13982,74,74,0
493000,1118000,13983,70,69,1
501000,1118000,13984,74,74,0
509000,1118000,13985,73,73,0
517000,1118000,13986,46,46,0
525000,1118000,13987,72,72,0
533000,1118000,13988,82,82,0
541000,1118000,13989,70,70,0
549000,1118000,13990,76,76,0
557000,1118000,13991,80,79,1
565000,1118000,13992,69,69,0
573000,1118000,13993,73,73,0
581000,1118000,13994,74,74,0
589000,1118000,13995,71,71,0
597000,1118000,13996,71,71,0
605000,1118000,13997,67,67,0
613000,1118000,13998,74,74,0
621000,1118000,13999,63,63,0
629000,1118000,14000,51,51,0
637000,1118000,14001,63,63,0
645000,1118000,14002,68,68,0
653000,1118000,14003,70,70,0
661000,1118000,14004,65,65,0
669000,1118000,14005,73,73,0
677000,1118000,14006,66,66,0
685000,1118000,14007,18,18,0
733000,1118000,14013,3,3,0
741000,1118000,14014,8,8,0
757000,1118000,14016,11,11,0
765000,1118000,14017,32,32,0
773000,1118000,14018,72,72,0
781000,1118000,14019,65,65,0
789000,1118000,14020,65,65,0
797000,1118000,14021,80,80,0
805000,1118000,14022,67,67,0
813000,1118000,14023,68,68,0
821000,1118000,14024,71,71,0
829000,1118000,14025,70,70,0
837000,1118000,14026,64,64,0
845000,1118000,14027,72,72,0
853000,1118000,14028,64,64,0
861000,1118000,14029,58,58,0
-35000,1110000,14213,13,0,13
-27000,1110000,14214,67,0,67
-19000,1110000,14215,74,0,74
-11000,1110000,14216,68,0,68
-3000,1110000,14217,80,0,80
5000,1110000,14218,63,0,63
13000,1110000,14219,59,0,59
21000,1110000,14220,66,0,66
29000,1110000,14221,55,6,49
37000,1110000,14222,66,1,65
45000,1110000,14223,60,13,47
53000,1110000,14224,57,35,22
61000,1110000,14225,54,47,7
69000,1110000,14226,57,57,0
77000,1110000,14227,69,65,4
85000,1110000,14228,70,68,2
93000,1110000,14229,73,73,0
101000,1110000,14230,73,71,2
109000,1110000,14231,70,68,2
117000,1110000,14232,71,71,0
125000,1110000,14233,68,68,0
133000,1110000,14234,67,67,0
141000,1110000,14235,63,62,1
149000,1110000,14236,51,43,8
157000,1110000,14237,40,27,13
165000,1110000,14238,46,15,31
173000,1110000,14239,47,39,8
181000,1110000,14240,64,64,0
189000,1110000,14241,72,70,2
197000,1110000,14242,46,45,1
205000,1110000,14243,65,65,0
213000,1110000,14244,65,65,0
221000,1110000,14245,74,74,0
229000,1110000,14246,69,69,0
237000,1110000,14247,77,77,0
245000,1110000,14248,75,75,0
253000,1110000,14249,68,67,1
261000,1110000,14250,72,72,0
269000,1110000,14251,67,67,0
277000,1110000,14252,72,72,0
285000,1110000,14253,72,72,0
293000,1110000,14254,72,72,0
301000,1110000,14255,77,77,0
309000,1110000,14256,74,74,0
317000,1110000,14257,75,75,0
325000,1110000,14258,68,68,0
333000,1110000,14259,69,69,0
341000,1110000,14260,66,66,0
349000,1110000,14261,72,72,0
357000,1110000,14262,59,57,2
365000,1110000,14263,63,63,0
373000,1110000,14264,75,75,0
381000,1110000,14265,68,68,0
389000,1110000,14266,66,66,0
397000,1110000,14267,73,69,4
405000,1110000,14268,72,72,0
413000,1110000,14269,74,74,0
421000,1110000,14270,69,69,0
429000,1110000,14271,75,75,0
437000,1110000,14272,72,71,1
445000,1110000,14273,72,72,0
453000,1110000,14274,74,74,0
461000,1110000,14275,74,74,0
469000,1110000,14276,77,77,0
477000,1110000,14277,67,67,0
485000,1110000,14278,71,71,0
493000,1110000,14279,71,71,0
501000,1110000,14280,73,73,0
509000,1110000,14281,69,69,0
517000,1110000,14282,70,70,0
525000,1110000,14283,73,73,0
533000,1110000,14284,83,83,0
541000,1110000,14285,73,73,0
549000,1110000,14286,70,70,0
557000,1110000,14287,82,82,0
565000,1110000,14288,79,79,0
573000,1110000,14289,82,82,0
581000,1110000,14290,80,80,0
589000,1110000,14291,75,75,0
597000,1110000,14292,81,81,0
605000,1110000,14293,71,71,0
613000,1110000,14294,78,78,0
621000,1110000,14295,76,76,0
629000,1110000,14296,66,66,0
637000,1110000,14297,61,61,0
645000,1110000,14298,66,66,0
653000,1110000,14299,66,66,0
661000,1110000,14300,68,68,0
669000,1110000,14301,64,64,0
677000,1110000,14302,71,71,0
685000,1110000,14303,63,63,0
693000,1110000,14304,32,32,0
701000,1110000,14305,42,42,0
709000,1110000,14306,64,64,0
717000,1110000,14307,30,30,0
733000,1110000,14309,13,13,0
741000,1110000,14310,40,40,0
749000,1110000,14311,34,34,0
757000,1110000,14312,73,73,0
765000,1110000,14313,83,83,0
773000,1110000,14314,81,81,0
781000,1110000,14315,75,75,0
789000,1110000,14316,73,73,0
797000,1110000,14317,85,85,0
805000,1110000,14318,68,68,0
813000,1110000,14319,69,69,0
821000,1110000,14320,72,72,0
829000,1110000,14321,74,74,0
837000,1110000,14322,68,68,0
845000,1110000,14323,80,80,0
853000,1110000,14324,70,70,0
861000,1110000,14325,48,48,0
925000,1110000,14333,8,8,0
933000,1110000,14334,5,5,0
-43000,1102000,14508,37,2,35
-35000,1102000,14509,70,0,70
-27000,1102000,14510,74,0,74
-19000,1102000,14511,71,0,71
-11000,1102000,14512,72,0,72
-3000,1102000,14513,85,0,85
5000,1102000,14514,59,0,59
13000,1102000,14515,65,0,65
21000,1102000,14516,62,0,62
29000,1102000,14517,73,0,73
37000,1102000,14518,70,1,69
45000,1102000,14519,52,29,23
53000,1102000,14520,46,45,1
61000,1102000,14521,55,48,7
69000,1102000,14522,60,49,11
77000,1102000,14523,68,14,54
85000,1102000,14524,48,27,21
93000,1102000,14525,67,64,3
101000,1102000,14526,68,59,9
109000,1102000,14527,69,69,0
117000,1102000,14528,73,69,4
125000,1102000,14529,67,67,0
133000,1102000,14530,73,73,0
141000,1102000,14531,52,52,0
149000,1102000,14532,50,50,0
157000,1102000,14533,46,40,6
165000,1102000,14534,50,34,16
173000,1102000,14535,61,56,5
181000,1102000,14536,63,63,0
189000,1102000,14537,77,77,0
197000,1102000,14538,70,67,3
205000,1102000,14539,70,70,0
213000,1102000,14540,73,73,0
221000,1102000,14541,67,65,2
229000,1102000,14542,67,67,0
237000,1102000,14543,69,69,0
245000,1102000,14544,75,75,0
253000,1102000,14545,66,66,0
261000,1102000,14546,72,72,0
269000,1102000,14547,71,71,0
277000,1102000,14548,72,71,1
285000,1102000,14549,73,73,0
293000,1102000,14550,72,72,0
301000,1102000,14551,73,73,0
309000,1102000,14552,72,72,0
317000,1102000,14553,70,70,0
325000,1102000,14554,66,66,0
333000,1102000,14555,61,61,0
341000,1102000,14556,68,68,0
349000,1102000,14557,74,73,1
357000,1102000,14558,70,70,0
365000,1102000,14559,73,73,0
373000,1102000,14560,70,70,0
381000,1102000,14561,68,68,0
389000,1102000,14562,74,74,0
397000,1102000,14563,63,62,1
405000,1102000,14564,73,73,0
413000,1102000,14565,73,73,0
421000,1102000,14566,74,73,1
429000,1102000,14567,73,73,0
437000,1102000,14568,71,71,0
445000,1102000,14569,75,75,0
453000,1102000,14570,74,74,0
461000,1102000,14571,68,68,0
469000,1102000,14572,72,72,0
477000,1102000,14573,72,72,0
485000,1102000,14574,67,67,0
493000,1102000,14575,68,68,0
501000,1102000,14576,65,65,0
509000,1102000,14577,70,70,0
517000,1102000,14578,73,73,0
525000,1102000,14579,74,74,0
533000,1102000,14580,74,74,0
541000,1102000,14581,77,77,0
549000,1102000,14582,83,83,0
557000,1102000,14583,86,86,0
565000,1102000,14584,67,67,0
573000,1102000,14585,69,69,0
581000,1102000,14586,67,67,0
589000,1102000,14587,72,72,0
597000,1102000,14588,65,65,0
605000,1102000,14589,69,69,0
613000,1102000,14590,69,69,0
621000,1102000,14591,66,66,0
629000,1102000,14592,79,79,0
637000,1102000,14593,69,69,0
645000,1102000,14594,69,69,0
653000,1102000,14595,67,67,0
661000,1102000,14596,70,70,0
669000,1102000,14597,63,63,0
677000,1102000,14598,69,69,0
685000,1102000,14599,75,75,0
693000,1102000,14600,70,70,0
701000,1102000,14601,72,72,0
709000,1102000,14602,71,71,0
717000,1102000,14603,73,73,0
725000,1102000,14604,46,46,0
733000,1102000,14605,64,64,0
741000,1102000,14606,44,44,0
749000,1102000,14607,71,71,0
757000,1102000,14608,74,74,0
765000,1102000,14609,74,74,0
773000,1102000,14610,72,72,0
781000,1102000,14611,72,72,0
789000,1102000,14612,74,74,0
797000,1102000,14613,78,78,0
805000,1102000,14614,67,67,0
813000,1102000,14615,71,71,0
821000,1102000,14616,71,71,0
829000,1102000,14617,65,65,0
837000,1102000,14618,74,74,0
845000,1102000,14619,82,82,0
853000,1102000,14620,72,72,0
861000,1102000,14621,61,61,0
869000,1102000,14622,40,40,0
877000,1102000,14623,19,19,0
885000,1102000,14624,26,25,1
893000,1102000,14625,35,35,0
909000,1102000,14627,27,27,0
917000,1102000,14628,41,41,0
925000,1102000,14629,55,55,0
933000,1102000,14630,12,12,0
-51000,1094000,14803,1,0,1
-43000,1094000,14804,60,0,60
-35000,1094000,14805,69,0,69
-27000,1094000,14806,72,0,72
-19000,1094000,14807,70,0,70
-11000,1094000,14808,78,0,78
-3000,1094000,14809,74,0,74
5000,1094000,14810,57,0,57
13000,1094000,14811,61,0,61
21000,1094000,14812,57,0,57
29000,1094000,14813,82,0,82
37000,1094000,14814,77,0,77
45000,1094000,14815,69,7,62
53000,1094000,14816,58,6,52
61000,1094000,14817,60,30,30
69000,1094000,14818,71,7,64
77000,1094000,14819,72,6,66
85000,1094000,14820,69,8,61
93000,1094000,14821,64,54,10
101000,1094000,14822,59,58,1
109000,1094000,14823,58,58,0
117000,1094000,14824,68,68,0
125000,1094000,14825,69,69,0
133000,1094000,14826,73,72,1
141000,1094000,14827,64,61,3
149000,1094000,14828,46,43,3
157000,1094000,14829,51,36,15
165000,1094000,14830,51,51,0
173000,1094000,14831,78,78,0
181000,1094000,14832,70,70,0
189000,1094000,14833,71,71,0
197000,1094000,14834,69,69,0
205000,1094000,14835,82,82,0
213000,1094000,14836,77,77,0
221000,1094000,14837,74,72,2
229000,1094000,14838,70,69,1
237000,1094000,14839,76,76,0
245000,1094000,14840,84,84,0
253000,1094000,14841,80,80,0
261000,1094000,14842,71,71,0
269000,1094000,14843,69,69,0
277000,1094000,14844,72,72,0
285000,1094000,14845,66,64,2
293000,1094000,14846,74,73,1
301000,1094000,14847,75,75,0
309000,1094000,14848,64,64,0
317000,1094000,14849,66,65,1
325000,1094000,14850,70,70,0
333000,1094000,14851,61,61,0
341000,1094000,14852,63,63,0
349000,1094000,14853,74,74,0
357000,1094000,14854,75,75,0
365000,1094000,14855,74,74,0
373000,1094000,14856,72,72,0
381000,1094000,14857,71,71,0
389000,1094000,14858,68,68,0
397000,1094000,14859,70,69,1
405000,1094000,14860,66,66,0
413000,1094000,14861,75,75,0
421000,1094000,14862,73,73,0
429000,1094000,14863,75,75,0
437000,1094000,14864,74,74,0
445000,1094000,14865,75,75,0
453000,1094000,14866,74,74,0
461000,1094000,14867,70,70,0
469000,1094000,14868,77,77,0
477000,1094000,14869,65,65,0
485000,1094000,14870,71,71,0
493000,1094000,14871,62,62,0
501000,1094000,14872,52,52,0
509000,1094000,14873,57,57,0
517000,1094000,14874,63,63,0
525000,1094000,14875,55,55,0
533000,1094000,14876,66,66,0
541000,1094000,14877,67,67,0
549000,1094000,14878,70,70,0
557000,1094000,14879,75,75,0
565000,1094000,14880,69,69,0
573000,1094000,14881,73,73,0
581000,1094000,14882,75,75,0
589000,1094000,14883,72,72,0
597000,1094000,14884,71,71,0
605000,1094000,14885,74,74,0
613000,1094000,14886,71,71,0
621000,1094000,14887,71,71,0
629000,1094000,14888,74,74,0
637000,1094000,14889,61,61,0
645000,1094000,14890,70,70,0
653000,1094000,14891,72,72,0
661000,1094000,14892,65,65,0
669000,1094000,14893,67,67,0
677000,1094000,14894,67,67,0
685000,1094000,14895,66,65,1
693000,1094000,14896,71,71,0
701000,1094000,14897,71,71,0
709000,1094000,14898,74,74,0
717000,1094000,14899,73,73,0
725000,1094000,14900,72,72,0
733000,1094000,14901,72,72,0
741000,1094000,14902,74,74,0
749000,1094000,14903,84,84,0
757000,1094000,14904,84,84,0
765000,1094000,14905,69,69,0
773000,1094000,14906,68,68,0
781000,1094000,14907,71,71,0
789000,1094000,14908,71,71,0
797000,1094000,14909,74,74,0
805000,1094000,14910,71,71,0
813000,1094000,14911,70,70,0
821000,1094000,14912,70,70,0
829000,1094000,14913,69,69,0
837000,1094000,14914,68,68,0
845000,1094000,14915,76,76,0
853000,1094000,14916,68,68,0
861000,1094000,14917,63,63,0
869000,1094000,14918,73,73,0
877000,1094000,14919,73,73,0
885000,1094000,14920,72,72,0
893000,1094000,14921,68,68,0
901000,1094000,14922,60,60,0
909000,1094000,14923,53,53,0
917000,1094000,14924,69,69,0
925000,1094000,14925,43,43,0
933000,1094000,14926,3,3,0
-43000,1086000,15100,76,0,76
-35000,1086000,15101,71,0,71
-27000,1086000,15102,70,0,70
-19000,1086000,15103,76,0,76
-11000,1086000,15104,84,0,84
-3000,1086000,15105,65,0,65
5000,1086000,15106,51,0,51
13000,1086000,15107,73,0,73
21000,1086000,15108,63,0,63
29000,1086000,15109,64,0,64
37000,1086000,15110,67,0,67
45000,1086000,15111,65,1,64
53000,1086000,15112,65,11,54
61000,1086000,15113,66,2,64
69000,1086000,15114,58,8,50
77000,1086000,15115,78,1,77
85000,1086000,15116,76,2,74
93000,1086000,15117,68,30,38
101000,1086000,15118,71,71,0
109000,1086000,15119,61,61,0
117000,1086000,15120,73,73,0
125000,1086000,15121,77,77,0
133000,1086000,15122,68,68,0
141000,1086000,15123,75,63,12
149000,1086000,15124,61,42,19
157000,1086000,15125,54,19,35
165000,1086000,15126,58,52,6
173000,1086000,15127,79,79,0
181000,1086000,15128,77,77,0
189000,1086000,15129,72,72,0
197000,1086000,15130,70,70,0
205000,1086000,15131,77,77,0
213000,1086000,15132,67,67,0
221000,1086000,15133,66,66,0
229000,1086000,15134,61,61,0
237000,1086000,15135,75,75,0
245000,1086000,15136,71,71,0
253000,1086000,15137,68,68,0
261000,1086000,15138,78,78,0
269000,1086000,15139,79,79,0
277000,1086000,15140,75,75,0
285000,1086000,15141,65,61,4
293000,1086000,15142,65,65,0
301000,1086000,15143,65,64,1
309000,1086000,15144,73,73,0
317000,1086000,15145,59,58,1
325000,1086000,15146,71,71,0
333000,1086000,15147,71,71,0
341000,1086000,15148,62,62,0
349000,1086000,15149,67,67,0
357000,1086000,15150,71,71,0
365000,1086000,15151,71,71,0
373000,1086000,15152,73,73,0
381000,1086000,15153,64,64,0
389000,1086000,15154,71,71,0
397000,1086000,15155,67,67,0
405000,1086000,15156,71,71,0
413000,1086000,15157,69,69,0
421000,1086000,15158,75,75,0
429000,1086000,15159,72,72,0
437000,1086000,15160,74,74,0
445000,1086000,15161,75,75,0
453000,1086000,15162,68,68,0
461000,1086000,15163,66,65,1
469000,1086000,15164,59,58,1
477000,1086000,15165,59,59,0
485000,1086000,15166,64,63,1
493000,1086000,15167,66,66,0
501000,1086000,15168,63,63,0
509000,1086000,15169,60,60,0
517000,1086000,15170,61,61,0
525000,1086000,15171,51,51,0
533000,1086000,15172,55,53,2
541000,1086000,15173,64,64,0
549000,1086000,15174,70,70,0
557000,1086000,15175,79,79,0
565000,1086000,15176,72,72,0
573000,1086000,15177,70,70,0
581000,1086000,15178,72,72,0
589000,1086000,15179,71,71,0
597000,1086000,15180,72,72,0
605000,1086000,15181,72,72,0
613000,1086000,15182,72,72,0
621000,1086000,15183,70,70,0
629000,1086000,15184,51,50,1
637000,1086000,15185,47,46,1
645000,1086000,15186,47,47,0
653000,1086000,15187,48,48,0
661000,1086000,15188,55,55,0
669000,1086000,15189,72,72,0
677000,1086000,15190,68,68,0
685000,1086000,15191,63,63,0
693000,1086000,15192,71,71,0
701000,1086000,15193,68,68,0
709000,1086000,15194,72,72,0
717000,1086000,15195,69,69,0
725000,1086000,15196,67,67,0
733000,1086000,15197,65,65,0
741000,1086000,15198,73,73,0
749000,1086000,15199,70,70,0
757000,1086000,15200,70,70,0
765000,1086000,15201,68,68,0
773000,1086000,15202,68,68,0
781000,1086000,15203,32,32,0
789000,1086000,15204,37,37,0
797000,1086000,15205,78,78,0
805000,1086000,15206,68,68,0
813000,1086000,15207,68,68,0
821000,1086000,15208,70,70,0
829000,1086000,15209,73,73,0
837000,1086000,15210,69,69,0
845000,1086000,15211,73,73,0
853000,1086000,15212,48,48,0
861000,1086000,15213,69,69,0
869000,1086000,15214,72,72,0
877000,1086000,15215,73,73,0
885000,1086000,15216,73,73,0
893000,1086000,15217,74,74,0
901000,1086000,15218,71,71,0
909000,1086000,15219,60,60,0
917000,1086000,15220,63,63,0
925000,1086000,15221,37,37,0
933000,1086000,15222,25,25,0
-51000,1078000,15395,1,1,0
-43000,1078000,15396,45,1,44
-35000,1078000,15397,69,0,69
-27000,1078000,15398,63,0,63
-19000,1078000,15399,55,0,55
-11000,1078000,15400,63,0,63
-3000,1078000,15401,63,0,63
5000,1078000,15402,58,0,58
13000,1078000,15403,62,0,62
21000,1078000,15404,71,0,71
29000,1078000,15405,68,2,66
37000,1078000,15406,68,1,67
45000,1078000,15407,66,2,64
53000,1078000,15408,46,8,38
61000,1078000,15409,62,7,55
69000,1078000,15410,70,9,61
77000,1078000,15411,70,8,62
85000,1078000,15412,70,1,69
93000,1078000,15413,74,5,69
101000,1078000,15414,70,47,23
109000,1078000,15415,65,60,5
117000,1078000,15416,55,55,0
125000,1078000,15417,69,69,0
133000,1078000,15418,70,70,0
141000,1078000,15419,69,69,0
149000,1078000,15420,71,36,35
157000,1078000,15421,50,36,14
165000,1078000,15422,59,59,0
173000,1078000,15423,68,68,0
181000,1078000,15424,77,77,0
189000,1078000,15425,78,78,0
197000,1078000,15426,74,73,1
205000,1078000,15427,76,73,3
213000,1078000,15428,70,70,0
221000,1078000,15429,65,63,2
229000,1078000,15430,57,55,2
237000,1078000,15431,69,69,0
245000,1078000,15432,61,61,0
253000,1078000,15433,67,67,0
261000,1078000,15434,76,73,3
269000,1078000,15435,67,67,0
277000,1078000,15436,72,64,8
285000,1078000,15437,70,69,1
293000,1078000,15438,51,51,0
301000,1078000,15439,47,47,0
309000,1078000,15440,46,45,1
317000,1078000,15441,54,54,0
325000,1078000,15442,53,52,1
333000,1078000,15443,65,58,7
341000,1078000,15444,59,56,3
349000,1078000,15445,63,60,3
357000,1078000,15446,77,75,2
365000,1078000,15447,77,77,0
373000,1078000,15448,71,71,0
381000,1078000,15449,69,69,0
389000,1078000,15450,73,72,1
397000,1078000,15451,74,74,0
405000,1078000,15452,80,80,0
413000,1078000,15453,72,72,0
421000,1078000,15454,75,75,0
429000,1078000,15455,74,74,0
437000,1078000,15456,72,72,0
445000,1078000,15457,75,75,0
453000,1078000,15458,71,71,0
461000,1078000,15459,69,69,0
469000,1078000,15460,64,64,0
477000,1078000,15461,66,66,0
485000,1078000,15462,60,53,7
493000,1078000,15463,57,57,0
501000,1078000,15464,65,65,0
509000,1078000,15465,57,57,0
517000,1078000,15466,63,62,1
525000,1078000,15467,65,65,0
533000,1078000,15468,64,64,0
541000,1078000,15469,68,67,1
549000,1078000,15470,44,44,0
557000,1078000,15471,72,72,0
565000,1078000,15472,68,68,0
573000,1078000,15473,70,70,0
581000,1078000,15474,72,72,0
589000,1078000,15475,72,72,0
597000,1078000,15476,69,69,0
605000,1078000,15477,65,65,0
613000,1078000,15478,62,62,0
621000,1078000,15479,71,70,1
629000,1078000,15480,23,22,1
637000,1078000,15481,20,19,1
645000,1078000,15482,19,19,0
653000,1078000,15483,28,28,0
661000,1078000,15484,43,41,2
669000,1078000,15485,69,69,0
677000,1078000,15486,66,66,0
685000,1078000,15487,71,71,0
693000,1078000,15488,72,72,0
701000,1078000,15489,72,72,0
709000,1078000,15490,71,71,0
717000,1078000,15491,70,70,0
725000,1078000,15492,72,72,0
733000,1078000,15493,65,65,0
741000,1078000,15494,73,73,0
749000,1078000,15495,64,64,0
757000,1078000,15496,68,68,0
765000,1078000,15497,73,72,1
773000,1078000,15498,69,69,0
781000,1078000,15499,54,54,0
789000,1078000,15500,63,63,0
797000,1078000,15501,80,80,0
805000,1078000,15502,34,34,0
813000,1078000,15503,80,80,0
821000,1078000,15504,83,83,0
829000,1078000,15505,76,76,0
837000,1078000,15506,79,79,0
845000,1078000,15507,75,75,0
853000,1078000,15508,69,69,0
861000,1078000,15509,65,65,0
869000,1078000,15510,69,69,0
877000,1078000,15511,73,72,1
885000,1078000,15512,69,69,0
893000,1078000,15513,65,64,1
901000,1078000,15514,67,67,0
909000,1078000,15515,65,65,0
917000,1078000,15516,64,64,0
925000,1078000,15517,51,51,0
933000,1078000,15518,26,26,0
-43000,1070000,15692,13,0,13
-35000,1070000,15693,67,0,67
-27000,1070000,15694,60,0,60
-19000,1070000,15695,61,0,61
-11000,1070000,15696,69,0,69
-3000,1070000,15697,67,0,67
5000,1070000,15698,64,0,64
13000,1070000,15699,74,0,74
21000,1070000,15700,71,0,71
29000,1070000,15701,78,0,78
37000,1070000,15702,59,1,58
45000,1070000,15703,70,3,67
53000,1070000,15704,66,3,63
61000,1070000,15705,75,5,70
69000,1070000,15706,77,1,76
77000,1070000,15707,81,3,78
85000,1070000,15708,75,10,65
93000,1070000,15709,77,3,74
101000,1070000,15710,73,35,38
109000,1070000,15711,56,45,11
117000,1070000,15712,55,55,0
125000,1070000,15713,71,71,0
133000,1070000,15714,69,68,1
141000,1070000,15715,72,72,0
149000,1070000,15716,63,53,10
157000,1070000,15717,53,53,0
165000,1070000,15718,68,68,0
173000,1070000,15719,70,70,0
181000,1070000,15720,73,73,0
189000,1070000,15721,71,71,0
197000,1070000,15722,72,72,0
205000,1070000,15723,73,69,4
213000,1070000,15724,73,73,0
221000,1070000,15725,74,73,1
229000,1070000,15726,61,61,0
237000,1070000,15727,65,65,0
245000,1070000,15728,68,68,0
253000,1070000,15729,73,73,0
261000,1070000,15730,68,68,0
269000,1070000,15731,65,64,1
277000,1070000,15732,63,57,6
285000,1070000,15733,72,70,2
293000,1070000,15734,62,62,0
301000,1070000,15735,58,56,2
309000,1070000,15736,66,66,0
317000,1070000,15737,66,66,0
325000,1070000,15738,60,59,1
333000,1070000,15739,68,68,0
341000,1070000,15740,68,65,3
349000,1070000,15741,70,68,2
357000,1070000,15742,69,68,1
365000,1070000,15743,45,45,0
373000,1070000,15744,60,60,0
381000,1070000,15745,68,67,1
389000,1070000,15746,66,66,0
397000,1070000,15747,73,73,0
405000,1070000,15748,69,69,0
413000,1070000,15749,78,78,0
421000,1070000,15750,83,83,0
429000,1070000,15751,76,76,0
437000,1070000,15752,68,68,0
445000,1070000,15753,67,67,0
453000,1070000,15754,76,76,0
461000,1070000,15755,79,78,1
469000,1070000,15756,74,73,1
477000,1070000,15757,73,73,0
485000,1070000,15758,64,64,0
493000,1070000,15759,57,57,0
501000,1070000,15760,58,58,0
509000,1070000,15761,61,60,1
517000,1070000,15762,50,50,0
525000,1070000,15763,66,66,0
533000,1070000,15764,68,68,0
541000,1070000,15765,59,59,0
549000,1070000,15766,64,64,0
557000,1070000,15767,61,61,0
565000,1070000,15768,70,70,0
573000,1070000,15769,55,55,0
581000,1070000,15770,70,70,0
589000,1070000,15771,70,70,0
597000,1070000,15772,61,61,0
605000,1070000,15773,69,69,0
613000,1070000,15774,68,68,0
621000,1070000,15775,74,73,1
629000,1070000,15776,34,34,0
637000,1070000,15777,31,31,0
645000,1070000,15778,32,32,0
653000,1070000,15779,53,53,0
661000,1070000,15780,81,81,0
669000,1070000,15781,72,72,0
677000,1070000,15782,73,73,0
685000,1070000,15783,71,70,1
693000,1070000,15784,76,76,0
701000,1070000,15785,78,78,0
709000,1070000,15786,78,78,0
717000,1070000,15787,78,78,0
725000,1070000,15788,77,77,0
733000,1070000,15789,73,73,0
741000,1070000,15790,78,78,0
749000,1070000,15791,77,77,0
757000,1070000,15792,69,69,0
765000,1070000,15793,68,68,0
773000,1070000,15794,64,64,0
781000,1070000,15795,64,64,0
789000,1070000,15796,72,72,0
797000,1070000,15797,74,74,0
805000,1070000,15798,52,52,0
813000,1070000,15799,69,69,0
821000,1070000,15800,67,67,0
829000,1070000,15801,70,70,0
837000,1070000,15802,69,69,0
845000,1070000,15803,65,65,0
853000,1070000,15804,68,68,0
861000,1070000,15805,70,70,0
869000,1070000,15806,81,81,0
877000,1070000,15807,81,81,0
885000,1070000,15808,76,76,0
893000,1070000,15809,61,61,0
901000,1070000,15810,64,64,0
909000,1070000,15811,72,72,0
917000,1070000,15812,72,72,0
925000,1070000,15813,27,27,0
933000,1070000,15814,10,10,0
-35000,1062000,15989,5,0,5
-27000,1062000,15990,59,0,59
-19000,1062000,15991,45,1,44
-11000,1062000,15992,66,0,66
-3000,1062000,15993,73,0,73
5000,1062000,15994,77,0,77
13000,1062000,15995,78,0,78
21000,1062000,15996,74,0,74
29000,1062000,15997,79,0,79
37000,1062000,15998,70,0,70
45000,1062000,15999,64,7,57
53000,1062000,16000,64,7,57
61000,1062000,16001,65,15,50
69000,1062000,16002,62,0,62
77000,1062000,16003,77,6,71
85000,1062000,16004,72,2,70
93000,1062000,16005,70,4,66
101000,1062000,16006,72,3,69
109000,1062000,16007,71,53,18
117000,1062000,16008,57,47,10
125000,1062000,16009,64,62,2
133000,1062000,16010,72,72,0
141000,1062000,16011,73,56,17
149000,1062000,16012,67,53,14
157000,1062000,16013,45,42,3
165000,1062000,16014,56,55,1
173000,1062000,16015,71,71,0
181000,1062000,16016,76,76,0
189000,1062000,16017,66,66,0
197000,1062000,16018,68,68,0
205000,1062000,16019,66,66,0
213000,1062000,16020,68,67,1
221000,1062000,16021,71,71,0
229000,1062000,16022,76,76,0
237000,1062000,16023,67,67,0
245000,1062000,16024,73,73,0
253000,1062000,16025,73,73,0
261000,1062000,16026,69,66,3
269000,1062000,16027,68,67,1
277000,1062000,16028,71,71,0
285000,1062000,16029,67,67,0
293000,1062000,16030,64,64,0
301000,1062000,16031,60,60,0
309000,1062000,16032,69,69,0
317000,1062000,16033,67,66,1
325000,1062000,16034,68,67,1
333000,1062000,16035,64,63,1
341000,1062000,16036,72,72,0
349000,1062000,16037,72,72,0
357000,1062000,16038,64,64,0
365000,1062000,16039,58,58,0
373000,1062000,16040,72,72,0
381000,1062000,16041,73,72,1
389000,1062000,16042,72,72,0
397000,1062000,16043,74,74,0
405000,1062000,16044,69,69,0
413000,1062000,16045,73,73,0
421000,1062000,16046,78,78,0
429000,1062000,16047,74,74,0
437000,1062000,16048,76,76,0
445000,1062000,16049,63,63,0
453000,1062000,16050,77,77,0
461000,1062000,16051,78,78,0
469000,1062000,16052,78,78,0
477000,1062000,16053,71,71,0
485000,1062000,16054,43,43,0
493000,1062000,16055,51,51,0
501000,1062000,16056,69,67,2
509000,1062000,16057,75,74,1
517000,1062000,16058,66,66,0
525000,1062000,16059,73,72,1
533000,1062000,16060,76,75,1
541000,1062000,16061,66,66,0
549000,1062000,16062,72,71,1
557000,1062000,16063,73,73,0
565000,1062000,16064,79,79,0
573000,1062000,16065,78,78,0
581000,1062000,16066,72,72,0
589000,1062000,16067,79,79,0
597000,1062000,16068,75,75,0
605000,1062000,16069,71,71,0
613000,1062000,16070,74,74,0
621000,1062000,16071,76,76,0
629000,1062000,16072,70,70,0
637000,1062000,16073,68,67,1
645000,1062000,16074,69,69,0
653000,1062000,16075,71,71,0
661000,1062000,16076,84,84,0
669000,1062000,16077,70,70,0
677000,1062000,16078,73,73,0
685000,1062000,16079,65,65,0
693000,1062000,16080,74,74,0
701000,1062000,16081,70,70,0
709000,1062000,16082,73,73,0
717000,1062000,16083,71,71,0
725000,1062000,16084,72,72,0
733000,1062000,16085,69,69,0
741000,1062000,16086,67,67,0
749000,1062000,16087,70,70,0
757000,1062000,16088,70,70,0
765000,1062000,16089,69,69,0
773000,1062000,16090,66,66,0
781000,1062000,16091,71,71,0
789000,1062000,16092,69,69,0
797000,1062000,16093,75,75,0
805000,1062000,16094,59,59,0
813000,1062000,16095,73,73,0
821000,1062000,16096,68,68,0
829000,1062000,16097,41,41,0
837000,1062000,16098,46,46,0
845000,1062000,16099,62,62,0
853000,1062000,16100,60,60,0
861000,1062000,16101,65,65,0
869000,1062000,16102,62,62,0
877000,1062000,16103,66,66,0
885000,1062000,16104,61,61,0
893000,1062000,16105,62,62,0
901000,1062000,16106,62,62,0
909000,1062000,16107,55,55,0
917000,1062000,16108,73,73,0
925000,1062000,16109,70,70,0
933000,1062000,16110,63,63,0
941000,1062000,16111,9,9,0
957000,1062000,16113,3,3,0
965000,1062000,16114,8,8,0
973000,1062000,16115,4,4,0
-27000,1054000,16286,50,1,49
-19000,1054000,16287,63,0,63
-11000,1054000,16288,68,0,68
-3000,1054000,16289,58,0,58
5000,1054000,16290,64,2,62
13000,1054000,16291,69,0,69
21000,1054000,16292,72,0,72
29000,1054000,16293,74,0,74
37000,1054000,16294,68,1,67
45000,1054000,16295,71,1,70
53000,1054000,16296,73,2,71
61000,1054000,16297,66,2,64
69000,1054000,16298,59,14,45
77000,1054000,16299,75,4,71
85000,1054000,16300,68,9,59
93000,1054000,16301,73,0,73
101000,1054000,16302,75,0,75
109000,1054000,16303,73,2,71
117000,1054000,16304,46,16,30
125000,1054000,16305,52,50,2
133000,1054000,16306,60,51,9
141000,1054000,16307,61,48,13
149000,1054000,16308,69,55,14
157000,1054000,16309,60,41,19
165000,1054000,16310,61,59,2
173000,1054000,16311,55,54,1
181000,1054000,16312,66,66,0
189000,1054000,16313,72,72,0
197000,1054000,16314,64,60,4
205000,1054000,16315,49,47,2
213000,1054000,16316,63,63,0
221000,1054000,16317,66,66,0
229000,1054000,16318,66,64,2
237000,1054000,16319,59,59,0
245000,1054000,16320,65,65,0
253000,1054000,16321,71,71,0
261000,1054000,16322,60,56,4
269000,1054000,16323,67,66,1
277000,1054000,16324,65,65,0
285000,1054000,16325,73,73,0
293000,1054000,16326,71,71,0
301000,1054000,16327,70,68,2
309000,1054000,16328,74,74,0
317000,1054000,16329,73,73,0
325000,1054000,16330,69,69,0
333000,1054000,16331,61,61,0
341000,1054000,16332,68,66,2
349000,1054000,16333,67,66,1
357000,1054000,16334,66,66,0
365000,1054000,16335,70,70,0
373000,1054000,16336,76,76,0
381000,1054000,16337,73,73,0
389000,1054000,16338,72,72,0
397000,1054000,16339,67,67,0
405000,1054000,16340,75,75,0
413000,1054000,16341,71,70,1
421000,1054000,16342,69,68,1
429000,1054000,16343,75,75,0
437000,1054000,16344,75,75,0
445000,1054000,16345,56,56,0
453000,1054000,16346,73,73,0
461000,1054000,16347,73,71,2
469000,1054000,16348,75,75,0
477000,1054000,16349,66,65,1
485000,1054000,16350,60,58,2
493000,1054000,16351,70,70,0
501000,1054000,16352,62,62,0
509000,1054000,16353,67,67,0
517000,1054000,16354,71,71,0
525000,1054000,16355,72,72,0
533000,1054000,16356,68,68,0
541000,1054000,16357,61,61,0
549000,1054000,16358,71,71,0
557000,1054000,16359,69,69,0
565000,1054000,16360,68,68,0
573000,1054000,16361,71,71,0
581000,1054000,16362,73,73,0
589000,1054000,16363,71,71,0
597000,1054000,16364,82,82,0
605000,1054000,16365,70,70,0
613000,1054000,16366,68,68,0
621000,1054000,16367,80,80,0
629000,1054000,16368,69,69,0
637000,1054000,16369,64,64,0
645000,1054000,16370,70,70,0
653000,1054000,16371,72,72,0
661000,1054000,16372,84,84,0
669000,1054000,16373,82,82,0
677000,1054000,16374,85,85,0
685000,1054000,16375,89,89,0
693000,1054000,16376,80,80,0
701000,1054000,16377,72,72,0
709000,1054000,16378,67,67,0
717000,1054000,16379,70,70,0
725000,1054000,16380,66,66,0
733000,1054000,16381,72,72,0
741000,1054000,16382,68,68,0
749000,1054000,16383,78,78,0
757000,1054000,16384,57,57,0
765000,1054000,16385,52,52,0
773000,1054000,16386,72,72,0
781000,1054000,16387,67,67,0
789000,1054000,16388,53,53,0
797000,1054000,16389,78,78,0
805000,1054000,16390,69,69,0
813000,1054000,16391,64,64,0
821000,1054000,16392,11,11,0
845000,1054000,16395,4,4,0
853000,1054000,16396,25,25,0
861000,1054000,16397,51,51,0
869000,1054000,16398,60,60,0
877000,1054000,16399,56,56,0
885000,1054000,16400,51,51,0
893000,1054000,16401,35,35,0
901000,1054000,16402,55,55,0
909000,1054000,16403,58,58,0
917000,1054000,16404,74,74,0
925000,1054000,16405,78,78,0
933000,1054000,16406,67,67,0
941000,1054000,16407,36,36,0
949000,1054000,16408,5,5,0
957000,1054000,16409,4,4,0
965000,1054000,16410,36,36,0
973000,1054000,16411,55,55,0
-27000,1046000,16582,61,1,60
-19000,1046000,16583,59,0,59
-11000,1046000,16584,70,0,70
-3000,1046000,16585,72,0,72
5000,1046000,16586,69,0,69
13000,1046000,16587,71,0,71
21000,1046000,16588,75,0,75
29000,1046000,16589,58,1,57
37000,1046000,16590,63,1,62
45000,1046000,16591,67,1,66
53000,1046000,16592,68,0,68
61000,1046000,16593,64,2,62
69000,1046000,16594,53,10,43
77000,1046000,16595,59,25,34
85000,1046000,16596,63,27,36
93000,1046000,16597,75,0,75
101000,1046000,16598,81,1,80
109000,1046000,16599,69,12,57
117000,1046000,16600,57,18,39
125000,1046000,16601,54,46,8
133000,1046000,16602,60,55,5
141000,1046000,16603,62,52,10
149000,1046000,16604,63,53,10
157000,1046000,16605,59,36,23
165000,1046000,16606,57,47,10
173000,1046000,16607,62,62,0
181000,1046000,16608,52,52,0
189000,1046000,16609,62,60,2
197000,1046000,16610,56,55,1
205000,1046000,16611,66,66,0
213000,1046000,16612,46,44,2
221000,1046000,16613,57,55,2
229000,1046000,16614,44,44,0
237000,1046000,16615,64,64,0
245000,1046000,16616,60,60,0
253000,1046000,16617,72,72,0
261000,1046000,16618,67,67,0
269000,1046000,16619,66,66,0
277000,1046000,16620,69,68,1
285000,1046000,16621,74,74,0
293000,1046000,16622,69,69,0
301000,1046000,16623,67,67,0
309000,1046000,16624,70,70,0
317000,1046000,16625,70,70,0
325000,1046000,16626,74,74,0
333000,1046000,16627,66,66,0
341000,1046000,16628,61,60,1
349000,1046000,16629,66,66,0
357000,1046000,16630,61,61,0
365000,1046000,16631,73,73,0
373000,1046000,16632,75,75,0
381000,1046000,16633,70,70,0
389000,1046000,16634,74,74,0
397000,1046000,16635,73,73,0
405000,1046000,16636,74,74,0
413000,1046000,16637,73,73,0
421000,1046000,16638,70,70,0
429000,1046000,16639,73,73,0
437000,1046000,16640,75,75,0
445000,1046000,16641,61,61,0
453000,1046000,16642,74,73,1
461000,1046000,16643,70,70,0
469000,1046000,16644,74,74,0
477000,1046000,16645,69,69,0
485000,1046000,16646,70,70,0
493000,1046000,16647,71,70,1
501000,1046000,16648,54,54,0
509000,1046000,16649,57,57,0
517000,1046000,16650,65,63,2
525000,1046000,16651,67,67,0
533000,1046000,16652,63,63,0
541000,1046000,16653,53,53,0
549000,1046000,16654,70,70,0
557000,1046000,16655,67,67,0
565000,1046000,16656,77,76,1
573000,1046000,16657,72,72,0
581000,1046000,16658,66,66,0
589000,1046000,16659,74,74,0
597000,1046000,16660,70,70,0
605000,1046000,16661,70,70,0
613000,1046000,16662,76,76,0
621000,1046000,16663,62,62,0
629000,1046000,16664,73,73,0
637000,1046000,16665,74,74,0
645000,1046000,16666,69,69,0
653000,1046000,16667,82,82,0
661000,1046000,16668,84,84,0
669000,1046000,16669,77,77,0
677000,1046000,16670,77,77,0
685000,1046000,16671,92,92,0
693000,1046000,16672,71,71,0
701000,1046000,16673,70,70,0
709000,1046000,16674,66,66,0
717000,1046000,16675,66,66,0
725000,1046000,16676,69,69,0
733000,1046000,16677,68,68,0
741000,1046000,16678,59,59,0
749000,1046000,16679,78,78,0
757000,1046000,16680,70,70,0
765000,1046000,16681,37,37,0
773000,1046000,16682,20,20,0
781000,1046000,16683,13,13,0
789000,1046000,16684,37,37,0
797000,1046000,16685,22,22,0
805000,1046000,16686,16,16,0
813000,1046000,16687,17,17,0
869000,1046000,16694,28,28,0
877000,1046000,16695,52,52,0
885000,1046000,16696,44,44,0
893000,1046000,16697,2,2,0
901000,1046000,16698,14,14,0
909000,1046000,16699,19,19,0
917000,1046000,16700,31,31,0
925000,1046000,16701,26,26,0
933000,1046000,16702,35,35,0
941000,1046000,16703,39,39,0
949000,1046000,16704,23,23,0
957000,1046000,16705,46,46,0
965000,1046000,16706,66,66,0
973000,1046000,16707,63,63,0
981000,1046000,16708,31,31,0
-35000,1038000,16877,6,0,6
-27000,1038000,16878,69,1,68
-19000,1038000,16879,72,0,72
-11000,1038000,16880,58,0,58
-3000,1038000,16881,63,2,61
5000,1038000,16882,74,1,73
13000,1038000,16883,73,0,73
21000,1038000,16884,70,0,70
29000,1038000,16885,74,3,71
37000,1038000,16886,59,0,59
45000,1038000,16887,74,0,74
53000,1038000,16888,73,0,73
61000,1038000,16889,75,1,74
69000,1038000,16890,62,6,56
77000,1038000,16891,52,13,39
85000,1038000,16892,61,36,25
93000,1038000,16893,69,49,20
101000,1038000,16894,70,40,30
109000,1038000,16895,57,54,3
117000,1038000,16896,69,69,0
125000,1038000,16897,69,69,0
133000,1038000,16898,64,61,3
141000,1038000,16899,58,39,19
149000,1038000,16900,70,70,0
157000,1038000,16901,64,48,16
165000,1038000,16902,63,23,40
173000,1038000,16903,64,48,16
181000,1038000,16904,61,53,8
189000,1038000,16905,63,63,0
197000,1038000,16906,59,59,0
205000,1038000,16907,60,60,0
213000,1038000,16908,49,46,3
221000,1038000,16909,44,42,2
229000,1038000,16910,40,40,0
237000,1038000,16911,60,60,0
245000,1038000,16912,60,56,4
253000,1038000,16913,66,66,0
261000,1038000,16914,75,75,0
269000,1038000,16915,70,70,0
277000,1038000,16916,67,67,0
285000,1038000,16917,62,62,0
293000,1038000,16918,67,67,0
301000,1038000,16919,64,64,0
309000,1038000,16920,71,71,0
317000,1038000,16921,68,67,1
325000,1038000,16922,70,70,0
333000,1038000,16923,67,67,0
341000,1038000,16924,74,74,0
349000,1038000,16925,64,64,0
357000,1038000,16926,75,75,0
365000,1038000,16927,76,76,0
373000,1038000,16928,76,76,0
381000,1038000,16929,72,72,0
389000,1038000,16930,74,74,0
397000,1038000,16931,70,70,0
405000,1038000,16932,75,75,0
413000,1038000,16933,73,73,0
421000,1038000,16934,73,73,0
429000,1038000,16935,72,72,0
437000,1038000,16936,75,74,1
445000,1038000,16937,60,60,0
453000,1038000,16938,75,75,0
461000,1038000,16939,74,74,0
469000,1038000,16940,71,71,0
477000,1038000,16941,71,71,0
485000,1038000,16942,70,69,1
493000,1038000,16943,68,68,0
501000,1038000,16944,60,60,0
509000,1038000,16945,69,69,0
517000,1038000,16946,60,60,0
525000,1038000,16947,65,65,0
533000,1038000,16948,74,74,0
541000,1038000,16949,61,61,0
549000,1038000,16950,64,63,1
557000,1038000,16951,72,72,0
565000,1038000,16952,75,75,0
573000,1038000,16953,73,73,0
581000,1038000,16954,73,73,0
589000,1038000,16955,70,70,0
597000,1038000,16956,76,75,1
605000,1038000,16957,72,71,1
613000,1038000,16958,71,71,0
621000,1038000,16959,74,74,0
629000,1038000,16960,63,63,0
637000,1038000,16961,67,67,0
645000,1038000,16962,68,68,0
653000,1038000,16963,80,80,0
661000,1038000,16964,74,74,0
669000,1038000,16965,71,71,0
677000,1038000,16966,76,76,0
685000,1038000,16967,84,84,0
693000,1038000,16968,68,68,0
701000,1038000,16969,71,71,0
709000,1038000,16970,32,32,0
717000,1038000,16971,69,69,0
725000,1038000,16972,55,55,0
733000,1038000,16973,41,41,0
741000,1038000,16974,11,11,0
749000,1038000,16975,76,76,0
757000,1038000,16976,68,68,0
765000,1038000,16977,1,1,0
869000,1038000,16990,1,1,0
877000,1038000,16991,36,36,0
885000,1038000,16992,27,27,0
957000,1038000,17001,2,2,0
965000,1038000,17002,5,5,0
973000,1038000,17003,12,12,0
981000,1038000,17004,7,7,0
-35000,1030000,17173,17,0,17
-27000,1030000,17174,70,0,70
-19000,1030000,17175,73,0,73
-11000,1030000,17176,67,0,67
-3000,1030000,17177,72,0,72
5000,1030000,17178,74,0,74
13000,1030000,17179,75,0,75
21000,1030000,17180,79,1,78
29000,1030000,17181,72,0,72
37000,1030000,17182,62,0,62
45000,1030000,17183,75,0,75
53000,1030000,17184,73,0,73
61000,1030000,17185,75,0,75
69000,1030000,17186,79,1,78
77000,1030000,17187,58,3,55
85000,1030000,17188,57,14,43
93000,1030000,17189,58,23,35
101000,1030000,17190,82,6,76
109000,1030000,17191,61,37,24
117000,1030000,17192,66,66,0
125000,1030000,17193,65,64,1
133000,1030000,17194,68,67,1
141000,1030000,17195,68,65,3
149000,1030000,17196,54,54,0
157000,1030000,17197,57,56,1
165000,1030000,17198,57,54,3
173000,1030000,17199,59,32,27
181000,1030000,17200,55,49,6
189000,1030000,17201,60,59,1
197000,1030000,17202,63,62,1
205000,1030000,17203,62,62,0
213000,1030000,17204,45,44,1
221000,1030000,17205,53,52,1
229000,1030000,17206,47,46,1
237000,1030000,17207,67,65,2
245000,1030000,17208,65,65,0
253000,1030000,17209,62,62,0
261000,1030000,17210,71,71,0
269000,1030000,17211,62,62,0
277000,1030000,17212,65,65,0
285000,1030000,17213,55,55,0
293000,1030000,17214,66,66,0
301000,1030000,17215,66,66,0
309000,1030000,17216,69,69,0
317000,1030000,17217,74,74,0
325000,1030000,17218,71,71,0
333000,1030000,17219,73,73,0
341000,1030000,17220,62,62,0
349000,1030000,17221,71,71,0
357000,1030000,17222,76,76,0
365000,1030000,17223,76,76,0
373000,1030000,17224,69,69,0
381000,1030000,17225,71,71,0
389000,1030000,17226,72,72,0
397000,1030000,17227,74,74,0
405000,1030000,17228,69,69,0
413000,1030000,17229,71,71,0
421000,1030000,17230,71,71,0
429000,1030000,17231,74,74,0
437000,1030000,17232,75,75,0
445000,1030000,17233,59,59,0
453000,1030000,17234,73,73,0
461000,1030000,17235,73,73,0
469000,1030000,17236,72,72,0
477000,1030000,17237,73,73,0
485000,1030000,17238,66,65,1
493000,1030000,17239,57,57,0
501000,1030000,17240,62,62,0
509000,1030000,17241,69,69,0
517000,1030000,17242,62,62,0
525000,1030000,17243,71,71,0
533000,1030000,17244,66,66,0
541000,1030000,17245,63,63,0
549000,1030000,17246,72,72,0
557000,1030000,17247,64,64,0
565000,1030000,17248,72,72,0
573000,1030000,17249,70,70,0
581000,1030000,17250,73,73,0
589000,1030000,17251,71,71,0
597000,1030000,17252,74,74,0
605000,1030000,17253,71,71,0
613000,1030000,17254,73,73,0
621000,1030000,17255,80,80,0
629000,1030000,17256,77,77,0
637000,1030000,17257,67,67,0
645000,1030000,17258,71,71,0
653000,1030000,17259,82,82,0
661000,1030000,17260,73,73,0
669000,1030000,17261,73,73,0
677000,1030000,17262,73,73,0
685000,1030000,17263,78,78,0
693000,1030000,17264,72,72,0
701000,1030000,17265,64,64,0
709000,1030000,17266,24,24,0
717000,1030000,17267,69,69,0
725000,1030000,17268,26,26,0
741000,1030000,17270,33,33,0
749000,1030000,17271,78,78,0
757000,1030000,17272,25,25,0
-35000,1022000,17469,28,0,28
-27000,1022000,17470,68,0,68
-19000,1022000,17471,69,0,69
-11000,1022000,17472,66,0,66
-3000,1022000,17473,66,0,66
5000,1022000,17474,59,0,59
13000,1022000,17475,70,0,70
21000,1022000,17476,70,2,68
29000,1022000,17477,67,0,67
37000,1022000,17478,68,0,68
45000,1022000,17479,66,0,66
53000,1022000,17480,78,0,78
61000,1022000,17481,79,0,79
69000,1022000,17482,65,0,65
77000,1022000,17483,60,6,54
85000,1022000,17484,69,5,64
93000,1022000,17485,58,10,48
101000,1022000,17486,65,6,59
109000,1022000,17487,56,5,51
117000,1022000,17488,62,23,39
125000,1022000,17489,68,51,17
133000,1022000,17490,69,68,1
141000,1022000,17491,55,55,0
149000,1022000,17492,65,65,0
157000,1022000,17493,67,67,0
165000,1022000,17494,66,66,0
173000,1022000,17495,61,27,34
181000,1022000,17496,59,44,15
189000,1022000,17497,62,59,3
197000,1022000,17498,59,56,3
205000,1022000,17499,50,50,0
213000,1022000,17500,45,44,1
221000,1022000,17501,54,54,0
229000,1022000,17502,40,40,0
237000,1022000,17503,64,64,0
245000,1022000,17504,51,51,0
253000,1022000,17505,61,61,0
261000,1022000,17506,72,71,1
269000,1022000,17507,72,69,3
277000,1022000,17508,72,72,0
285000,1022000,17509,70,70,0
293000,1022000,17510,70,70,0
301000,1022000,17511,73,73,0
309000,1022000,17512,66,66,0
317000,1022000,17513,74,74,0
325000,1022000,17514,75,75,0
333000,1022000,17515,73,73,0
341000,1022000,17516,61,59,2
349000,1022000,17517,74,74,0
357000,1022000,17518,74,74,0
365000,1022000,17519,75,75,0
373000,1022000,17520,73,73,0
381000,1022000,17521,72,72,0
389000,1022000,17522,70,70,0
397000,1022000,17523,71,71,0
405000,1022000,17524,72,72,0
413000,1022000,17525,72,72,0
421000,1022000,17526,72,72,0
429000,1022000,17527,71,71,0
437000,1022000,17528,75,75,0
445000,1022000,17529,63,63,0
453000,1022000,17530,75,75,0
461000,1022000,17531,72,72,0
469000,1022000,17532,69,68,1
477000,1022000,17533,67,67,0
485000,1022000,17534,68,68,0
493000,1022000,17535,61,59,2
501000,1022000,17536,62,62,0
509000,1022000,17537,64,64,0
517000,1022000,17538,54,54,0
525000,1022000,17539,55,55,0
533000,1022000,17540,66,66,0
541000,1022000,17541,76,76,0
549000,1022000,17542,69,69,0
557000,1022000,17543,74,74,0
565000,1022000,17544,72,72,0
573000,1022000,17545,73,73,0
581000,1022000,17546,74,74,0
589000,1022000,17547,72,72,0
597000,1022000,17548,74,74,0
605000,1022000,17549,72,72,0
613000,1022000,17550,74,74,0
621000,1022000,17551,74,74,0
629000,1022000,17552,74,74,0
637000,1022000,17553,75,75,0
645000,1022000,17554,71,71,0
653000,1022000,17555,74,74,0
661000,1022000,17556,75,75,0
669000,1022000,17557,73,73,0
677000,1022000,17558,69,69,0
685000,1022000,17559,82,82,0
693000,1022000,17560,70,70,0
701000,1022000,17561,29,29,0
709000,1022000,17562,21,21,0
717000,1022000,17563,29,29,0
725000,1022000,17564,1,1,0
733000,1022000,17565,24,24,0
741000,1022000,17566,54,54,0
749000,1022000,17567,2,2,0
869000,1022000,17582,18,18,0
877000,1022000,17583,28,28,0
885000,1022000,17584,46,46,0
893000,1022000,17585,11,11,0
-35000,1014000,17765,32,0,32
-27000,1014000,17766,62,0,62
-19000,1014000,17767,68,0,68
-11000,1014000,17768,62,0,62
-3000,1014000,17769,71,1,70
5000,1014000,17770,70,0,70
13000,1014000,17771,68,4,64
21000,1014000,17772,69,3,66
29000,1014000,17773,70,0,70
37000,1014000,17774,71,0,71
45000,1014000,17775,60,0,60
53000,1014000,17776,58,0,58
61000,1014000,17777,76,0,76
69000,1014000,17778,60,0,60
77000,1014000,17779,66,4,62
85000,1014000,17780,63,4,59
93000,1014000,17781,63,7,56
101000,1014000,17782,68,13,55
109000,1014000,17783,56,12,44
117000,1014000,17784,62,11,51
125000,1014000,17785,58,35,23
133000,1014000,17786,58,54,4
141000,1014000,17787,64,64,0
149000,1014000,17788,65,65,0
157000,1014000,17789,64,64,0
165000,1014000,17790,63,63,0
173000,1014000,17791,59,58,1
181000,1014000,17792,56,56,0
189000,1014000,17793,71,71,0
197000,1014000,17794,61,56,5
205000,1014000,17795,61,53,8
213000,1014000,17796,50,50,0
221000,1014000,17797,30,30,0
229000,1014000,17798,50,50,0
237000,1014000,17799,63,63,0
245000,1014000,17800,62,62,0
253000,1014000,17801,72,72,0
261000,1014000,17802,66,65,1
269000,1014000,17803,70,70,0
277000,1014000,17804,66,66,0
285000,1014000,17805,63,63,0
293000,1014000,17806,74,74,0
301000,1014000,17807,69,68,1
309000,1014000,17808,73,73,0
317000,1014000,17809,75,75,0
325000,1014000,17810,73,73,0
333000,1014000,17811,75,75,0
341000,1014000,17812,65,61,4
349000,1014000,17813,74,74,0
357000,1014000,17814,72,72,0
365000,1014000,17815,74,73,1
373000,1014000,17816,71,71,0
381000,1014000,17817,71,71,0
389000,1014000,17818,71,71,0
397000,1014000,17819,73,73,0
405000,1014000,17820,73,73,0
413000,1014000,17821,76,76,0
421000,1014000,17822,71,71,0
429000,1014000,17823,72,72,0
437000,1014000,17824,71,71,0
445000,1014000,17825,66,66,0
453000,1014000,17826,75,74,1
461000,1014000,17827,76,76,0
469000,1014000,17828,75,75,0
477000,1014000,17829,75,74,1
485000,1014000,17830,62,61,1
493000,1014000,17831,64,64,0
501000,1014000,17832,62,62,0
509000,1014000,17833,72,72,0
517000,1014000,17834,65,64,1
525000,1014000,17835,69,69,0
533000,1014000,17836,64,64,0
541000,1014000,17837,62,62,0
549000,1014000,17838,74,73,1
557000,1014000,17839,66,66,0
565000,1014000,17840,71,71,0
573000,1014000,17841,72,72,0
581000,1014000,17842,70,70,0
589000,1014000,17843,73,73,0
597000,1014000,17844,76,76,0
605000,1014000,17845,71,71,0
613000,1014000,17846,77,77,0
621000,1014000,17847,74,74,0
629000,1014000,17848,73,73,0
637000,1014000,17849,73,73,0
645000,1014000,17850,73,73,0
653000,1014000,17851,50,50,0
661000,1014000,17852,27,27,0
669000,1014000,17853,72,72,0
677000,1014000,17854,74,74,0
685000,1014000,17855,82,82,0
693000,1014000,17856,29,29,0
733000,1014000,17861,36,36,0
741000,1014000,17862,12,12,0
861000,1014000,17877,8,8,0
869000,1014000,17878,50,50,0
877000,1014000,17879,64,64,0
885000,1014000,17880,59,59,0
893000,1014000,17881,68,68,0
901000,1014000,17882,29,29,0
909000,1014000,17883,6,6,0
917000,1014000,17884,6,6,0
-35000,1006000,18061,51,0,51
-27000,1006000,18062,58,0,58
-19000,1006000,18063,66,0,66
-11000,1006000,18064,68,0,68
-3000,1006000,18065,81,0,81
5000,1006000,18066,73,0,73
13000,1006000,18067,71,1,70
21000,1006000,18068,68,6,62
29000,1006000,18069,71,0,71
37000,1006000,18070,72,0,72
45000,1006000,18071,58,0,58
53000,1006000,18072,62,0,62
61000,1006000,18073,62,0,62
69000,1006000,18074,55,0,55
77000,1006000,18075,61,0,61
85000,1006000,18076,44,2,42
93000,1006000,18077,62,5,57
101000,1006000,18078,68,3,65
109000,1006000,18079,49,15,34
117000,1006000,18080,55,8,47
125000,1006000,18081,52,32,20
133000,1006000,18082,66,66,0
141000,1006000,18083,69,69,0
149000,1006000,18084,69,69,0
157000,1006000,18085,68,68,0
165000,1006000,18086,63,63,0
173000,1006000,18087,61,61,0
181000,1006000,18088,66,66,0
189000,1006000,18089,68,67,1
197000,1006000,18090,63,63,0
205000,1006000,18091,66,54,12
213000,1006000,18092,37,31,6
221000,1006000,18093,45,45,0
229000,1006000,18094,45,45,0
237000,1006000,18095,74,74,0
245000,1006000,18096,55,55,0
253000,1006000,18097,57,49,8
261000,1006000,18098,67,62,5
269000,1006000,18099,67,67,0
277000,1006000,18100,53,42,11
285000,1006000,18101,73,73,0
293000,1006000,18102,69,69,0
301000,1006000,18103,75,75,0
309000,1006000,18104,75,75,0
317000,1006000,18105,74,74,0
325000,1006000,18106,75,75,0
333000,1006000,18107,72,71,1
341000,1006000,18108,72,72,0
349000,1006000,18109,68,67,1
357000,1006000,18110,70,70,0
365000,1006000,18111,73,73,0
373000,1006000,18112,69,69,0
381000,1006000,18113,74,74,0
389000,1006000,18114,70,70,0
397000,1006000,18115,68,68,0
405000,1006000,18116,74,74,0
413000,1006000,18117,72,71,1
421000,1006000,18118,72,72,0
429000,1006000,18119,70,68,2
437000,1006000,18120,62,59,3
445000,1006000,18121,72,72,0
453000,1006000,18122,73,73,0
461000,1006000,18123,71,71,0
469000,1006000,18124,72,72,0
477000,1006000,18125,76,76,0
485000,1006000,18126,72,72,0
493000,1006000,18127,71,71,0
501000,1006000,18128,69,69,0
509000,1006000,18129,69,69,0
517000,1006000,18130,67,67,0
525000,1006000,18131,63,63,0
533000,1006000,18132,64,64,0
541000,1006000,18133,69,69,0
549000,1006000,18134,71,68,3
557000,1006000,18135,70,69,1
565000,1006000,18136,66,66,0
573000,1006000,18137,74,73,1
581000,1006000,18138,72,72,0
589000,1006000,18139,70,70,0
597000,1006000,18140,74,74,0
605000,1006000,18141,72,72,0
613000,1006000,18142,75,75,0
621000,1006000,18143,71,71,0
629000,1006000,18144,77,77,0
637000,1006000,18145,76,76,0
645000,1006000,18146,72,72,0
653000,1006000,18147,67,67,0
661000,1006000,18148,62,62,0
669000,1006000,18149,72,72,0
677000,1006000,18150,74,74,0
685000,1006000,18151,70,70,0
733000,1006000,18157,11,11,0
741000,1006000,18158,1,1,0
853000,1006000,18172,9,9,0
861000,1006000,18173,66,66,0
869000,1006000,18174,70,70,0
877000,1006000,18175,59,59,0
885000,1006000,18176,59,59,0
893000,1006000,18177,68,68,0
901000,1006000,18178,83,83,0
909000,1006000,18179,69,69,0
917000,1006000,18180,72,72,0
925000,1006000,18181,54,54,0
933000,1006000,18182,1,1,0
-43000,998000,18356,1,0,1
-35000,998000,18357,72,1,71
-27000,998000,18358,71,0,71
-19000,998000,18359,71,0,71
-11000,998000,18360,69,0,69
-3000,998000,18361,77,0,77
5000,998000,18362,72,0,72
13000,998000,18363,79,0,79
21000,998000,18364,71,0,71
29000,998000,18365,64,5,59
37000,998000,18366,76,0,76
45000,998000,18367,57,0,57
53000,998000,18368,60,0,60
61000,998000,18369,77,0,77
69000,998000,18370,68,0,68
77000,998000,18371,61,0,61
85000,998000,18372,50,4,46
93000,998000,18373,71,0,71
101000,998000,18374,72,2,70
109000,998000,18375,54,4,50
117000,998000,18376,50,17,33
125000,998000,18377,61,61,0
133000,998000,18378,55,55,0
141000,998000,18379,65,65,0
149000,998000,18380,66,66,0
157000,998000,18381,59,59,0
165000,998000,18382,63,63,0
173000,998000,18383,62,62,0
181000,998000,18384,66,63,3
189000,998000,18385,61,60,1
197000,998000,18386,63,63,0
205000,998000,18387,67,37,30
213000,998000,18388,56,27,29
221000,998000,18389,59,59,0
229000,998000,18390,44,44,0
237000,998000,18391,56,53,3
245000,998000,18392,59,48,11
253000,998000,18393,56,52,4
261000,998000,18394,55,47,8
269000,998000,18395,54,26,28
277000,998000,18396,69,43,26
285000,998000,18397,69,69,0
293000,998000,18398,73,73,0
301000,998000,18399,71,71,0
309000,998000,18400,74,74,0
317000,998000,18401,68,52,16
325000,998000,18402,71,48,23
333000,998000,18403,65,58,7
341000,998000,18404,71,55,16
349000,998000,18405,71,71,0
357000,998000,18406,69,69,0
365000,998000,18407,65,65,0
373000,998000,18408,73,73,0
381000,998000,18409,69,69,0
389000,998000,18410,72,72,0
397000,998000,18411,66,66,0
405000,998000,18412,74,74,0
413000,998000,18413,76,76,0
421000,998000,18414,72,72,0
429000,998000,18415,70,67,3
437000,998000,18416,62,62,0
445000,998000,18417,72,72,0
453000,998000,18418,73,73,0
461000,998000,18419,72,72,0
469000,998000,18420,74,74,0
477000,998000,18421,74,74,0
485000,998000,18422,72,72,0
493000,998000,18423,72,71,1
501000,998000,18424,67,67,0
509000,998000,18425,67,67,0
517000,998000,18426,70,70,0
525000,998000,18427,72,72,0
533000,998000,18428,70,70,0
541000,998000,18429,69,67,2
549000,998000,18430,68,68,0
557000,998000,18431,60,59,1
565000,998000,18432,68,68,0
573000,998000,18433,72,72,0
581000,998000,18434,73,73,0
589000,998000,18435,73,73,0
597000,998000,18436,74,74,0
605000,998000,18437,73,73,0
613000,998000,18438,71,71,0
621000,998000,18439,75,73,2
629000,998000,18440,68,68,0
637000,998000,18441,69,69,0
645000,998000,18442,69,69,0
653000,998000,18443,74,74,0
661000,998000,18444,74,74,0
669000,998000,18445,70,70,0
677000,998000,18446,75,75,0
685000,998000,18447,21,21,0
853000,998000,18468,17,17,0
861000,998000,18469,66,66,0
869000,998000,18470,64,64,0
877000,998000,18471,72,72,0
885000,998000,18472,70,70,0
893000,998000,18473,58,58,0
901000,998000,18474,33,33,0
909000,998000,18475,73,73,0
917000,998000,18476,68,68,0
925000,998000,18477,75,74,1
933000,998000,18478,21,21,0
-43000,990000,18652,9,0,9
-35000,990000,18653,73,3,70
-27000,990000,18654,72,0,72
-19000,990000,18655,74,1,73
-11000,990000,18656,71,0,71
-3000,990000,18657,70,0,70
5000,990000,18658,71,0,71
13000,990000,18659,65,0,65
21000,990000,18660,66,0,66
29000,990000,18661,70,3,67
37000,990000,18662,72,2,70
45000,990000,18663,74,0,74
53000,990000,18664,64,0,64
61000,990000,18665,62,0,62
69000,990000,18666,70,0,70
77000,990000,18667,65,0,65
85000,990000,18668,63,0,63
93000,990000,18669,72,0,72
101000,990000,18670,72,0,72
109000,990000,18671,59,1,58
117000,990000,18672,71,11,60
125000,990000,18673,60,47,13
133000,990000,18674,61,61,0
141000,990000,18675,65,65,0
149000,990000,18676,69,69,0
157000,990000,18677,68,68,0
165000,990000,18678,68,68,0
173000,990000,18679,72,72,0
181000,990000,18680,56,56,0
189000,990000,18681,58,58,0
197000,990000,18682,66,66,0
205000,990000,18683,56,45,11
213000,990000,18684,64,56,8
221000,990000,18685,65,65,0
229000,990000,18686,54,54,0
237000,990000,18687,46,46,0
245000,990000,18688,56,56,0
253000,990000,18689,49,44,5
261000,990000,18690,68,25,43
269000,990000,18691,71,7,64
277000,990000,18692,77,23,54
285000,990000,18693,72,50,22
293000,990000,18694,69,65,4
301000,990000,18695,71,71,0
309000,990000,18696,71,71,0
317000,990000,18697,72,68,4
325000,990000,18698,74,53,21
333000,990000,18699,71,53,18
341000,990000,18700,70,36,34
349000,990000,18701,71,63,8
357000,990000,18702,73,73,0
365000,990000,18703,77,76,1
373000,990000,18704,74,74,0
381000,990000,18705,72,72,0
389000,990000,18706,73,73,0
397000,990000,18707,73,73,0
405000,990000,18708,72,72,0
413000,990000,18709,75,75,0
421000,990000,18710,71,71,0
429000,990000,18711,71,71,0
437000,990000,18712,60,60,0
445000,990000,18713,75,75,0
453000,990000,18714,71,71,0
461000,990000,18715,74,74,0
469000,990000,18716,73,73,0
477000,990000,18717,72,72,0
485000,990000,18718,70,70,0
493000,990000,18719,73,73,0
501000,990000,18720,69,69,0
509000,990000,18721,68,68,0
517000,990000,18722,70,70,0
525000,990000,18723,75,75,0
533000,990000,18724,64,64,0
541000,990000,18725,68,68,0
549000,990000,18726,71,70,1
557000,990000,18727,71,71,0
565000,990000,18728,69,69,0
573000,990000,18729,68,68,0
581000,990000,18730,74,74,0
589000,990000,18731,72,72,0
597000,990000,18732,72,72,0
605000,990000,18733,71,71,0
613000,990000,18734,69,69,0
621000,990000,18735,70,69,1
629000,990000,18736,70,70,0
637000,990000,18737,72,72,0
645000,990000,18738,70,70,0
653000,990000,18739,70,70,0
661000,990000,18740,74,74,0
669000,990000,18741,67,67,0
677000,990000,18742,57,57,0
709000,990000,18746,8,7,1
717000,990000,18747,17,17,0
725000,990000,18748,1,1,0
797000,990000,18757,8,8,0
805000,990000,18758,4,4,0
853000,990000,18764,1,1,0
861000,990000,18765,54,54,0
869000,990000,18766,65,65,0
877000,990000,18767,72,72,0
885000,990000,18768,56,56,0
893000,990000,18769,33,33,0
901000,990000,18770,55,55,0
909000,990000,18771,76,76,0
917000,990000,18772,42,42,0
925000,990000,18773,59,59,0
933000,990000,18774,63,63,0
941000,990000,18775,56,56,0
949000,990000,18776,39,39,0
-43000,982000,18948,20,0,20
-35000,982000,18949,77,2,75
-27000,982000,18950,78,1,77
-19000,982000,18951,76,0,76
-11000,982000,18952,71,0,71
-3000,982000,18953,65,0,65
5000,982000,18954,66,0,66
13000,982000,18955,59,0,59
21000,982000,18956,68,1,67
29000,982000,18957,70,1,69
37000,982000,18958,64,12,52
45000,982000,18959,74,8,66
53000,982000,18960,64,0,64
61000,982000,18961,59,0,59
69000,982000,18962,68,0,68
77000,982000,18963,65,0,65
85000,982000,18964,65,0,65
93000,982000,18965,63,0,63
101000,982000,18966,62,0,62
109000,982000,18967,50,1,49
117000,982000,18968,66,0,66
125000,982000,18969,65,3,62
133000,982000,18970,60,44,16
141000,982000,18971,68,68,0
149000,982000,18972,73,73,0
157000,982000,18973,72,72,0
165000,982000,18974,69,69,0
173000,982000,18975,69,69,0
181000,982000,18976,38,38,0
189000,982000,18977,32,32,0
197000,982000,18978,64,62,2
205000,982000,18979,55,52,3
213000,982000,18980,58,28,30
221000,982000,18981,53,50,3
229000,982000,18982,62,62,0
237000,982000,18983,67,67,0
245000,982000,18984,67,61,6
253000,982000,18985,54,43,11
261000,982000,18986,73,19,54
269000,982000,18987,73,2,71
277000,982000,18988,74,7,67
285000,982000,18989,73,71,2
293000,982000,18990,70,70,0
301000,982000,18991,71,71,0
309000,982000,18992,60,60,0
317000,982000,18993,68,63,5
325000,982000,18994,65,38,27
333000,982000,18995,71,31,40
341000,982000,18996,72,7,65
349000,982000,18997,62,29,33
357000,982000,18998,65,52,13
365000,982000,18999,74,72,2
373000,982000,19000,74,73,1
381000,982000,19001,73,73,0
389000,982000,19002,76,76,0
397000,982000,19003,79,79,0
405000,982000,19004,77,77,0
413000,982000,19005,70,70,0
421000,982000,19006,68,68,0
429000,982000,19007,73,73,0
437000,982000,19008,56,56,0
445000,982000,19009,74,74,0
453000,982000,19010,74,74,0
461000,982000,19011,71,71,0
469000,982000,19012,75,75,0
477000,982000,19013,73,72,1
485000,982000,19014,74,74,0
493000,982000,19015,70,70,0
501000,982000,19016,66,66,0
509000,982000,19017,71,70,1
517000,982000,19018,73,73,0
525000,982000,19019,72,72,0
533000,982000,19020,72,72,0
541000,982000,19021,72,72,0
549000,982000,19022,73,73,0
557000,982000,19023,74,74,0
565000,982000,19024,70,70,0
573000,982000,19025,72,72,0
581000,982000,19026,71,71,0
589000,982000,19027,68,68,0
597000,982000,19028,75,75,0
605000,982000,19029,70,69,1
613000,982000,19030,69,69,0
621000,982000,19031,71,71,0
629000,982000,19032,73,73,0
637000,982000,19033,78,78,0
645000,982000,19034,69,69,0
653000,982000,19035,73,73,0
661000,982000,19036,72,72,0
669000,982000,19037,66,66,0
677000,982000,19038,6,6,0
709000,982000,19042,12,11,1
717000,982000,19043,21,21,0
797000,982000,19053,8,8,0
845000,982000,19059,2,2,0
853000,982000,19060,12,12,0
861000,982000,19061,15,15,0
869000,982000,19062,38,38,0
877000,982000,19063,51,51,0
885000,982000,19064,80,80,0
893000,982000,19065,58,58,0
901000,982000,19066,74,74,0
909000,982000,19067,72,72,0
917000,982000,19068,70,70,0
925000,982000,19069,87,87,0
933000,982000,19070,73,73,0
941000,982000,19071,70,70,0
949000,982000,19072,73,73,0
957000,982000,19073,52,52,0
965000,982000,19074,25,25,0
973000,982000,19075,1,1,0
-43000,974000,19244,32,1,31
-35000,974000,19245,70,0,70
-27000,974000,19246,73,2,71
-19000,974000,19247,74,1,73
-11000,974000,19248,78,0,78
-3000,974000,19249,75,0,75
5000,974000,19250,66,0,66
13000,974000,19251,72,0,72
21000,974000,19252,71,0,71
29000,974000,19253,61,1,60
37000,974000,19254,71,0,71
45000,974000,19255,70,8,62
53000,974000,19256,68,7,61
61000,974000,19257,59,0,59
69000,974000,19258,65,0,65
77000,974000,19259,66,0,66
85000,974000,19260,54,0,54
93000,974000,19261,55,0,55
101000,974000,19262,56,0,56
109000,974000,19263,58,1,57
117000,974000,19264,58,0,58
125000,974000,19265,62,4,58
133000,974000,19266,67,23,44
141000,974000,19267,68,53,15
149000,974000,19268,70,70,0
157000,974000,19269,70,70,0
165000,974000,19270,63,62,1
173000,974000,19271,54,54,0
181000,974000,19272,61,61,0
189000,974000,19273,61,58,3
197000,974000,19274,65,62,3
205000,974000,19275,61,56,5
213000,974000,19276,39,21,18
221000,974000,19277,51,51,0
229000,974000,19278,60,58,2
237000,974000,19279,67,67,0
245000,974000,19280,64,56,8
253000,974000,19281,54,21,33
261000,974000,19282,69,13,56
269000,974000,19283,73,3,70
277000,974000,19284,74,5,69
285000,974000,19285,71,51,20
293000,974000,19286,67,67,0
301000,974000,19287,74,74,0
309000,974000,19288,72,72,0
317000,974000,19289,73,70,3
325000,974000,19290,68,43,25
333000,974000,19291,72,27,45
341000,974000,19292,70,16,54
349000,974000,19293,65,26,39
357000,974000,19294,63,48,15
365000,974000,19295,67,67,0
373000,974000,19296,74,74,0
381000,974000,19297,74,74,0
389000,974000,19298,74,74,0
397000,974000,19299,72,72,0
405000,974000,19300,73,73,0
413000,974000,19301,78,78,0
421000,974000,19302,75,75,0
429000,974000,19303,70,70,0
437000,974000,19304,69,69,0
445000,974000,19305,76,76,0
453000,974000,19306,75,75,0
461000,974000,19307,69,69,0
469000,974000,19308,70,70,0
477000,974000,19309,77,77,0
485000,974000,19310,71,71,0
493000,974000,19311,68,68,0
501000,974000,19312,69,69,0
509000,974000,19313,70,69,1
517000,974000,19314,75,74,1
525000,974000,19315,77,77,0
533000,974000,19316,72,72,0
541000,974000,19317,73,73,0
549000,974000,19318,73,73,0
557000,974000,19319,73,73,0
565000,974000,19320,74,73,1
573000,974000,19321,71,71,0
581000,974000,19322,73,73,0
589000,974000,19323,75,75,0
597000,974000,19324,66,66,0
605000,974000,19325,69,69,0
613000,974000,19326,73,73,0
621000,974000,19327,67,66,1
629000,974000,19328,69,68,1
637000,974000,19329,66,64,2
645000,974000,19330,76,76,0
653000,974000,19331,76,76,0
661000,974000,19332,74,74,0
669000,974000,19333,33,33,0
701000,974000,19337,22,22,0
709000,974000,19338,11,11,0
717000,974000,19339,1,1,0
837000,974000,19354,17,17,0
845000,974000,19355,36,36,0
853000,974000,19356,69,69,0
861000,974000,19357,69,69,0
869000,974000,19358,69,69,0
877000,974000,19359,79,79,0
885000,974000,19360,84,84,0
893000,974000,19361,65,65,0
901000,974000,19362,69,69,0
909000,974000,19363,78,78,0
917000,974000,19364,70,70,0
925000,974000,19365,85,85,0
933000,974000,19366,78,78,0
941000,974000,19367,72,71,1
949000,974000,19368,71,71,0
957000,974000,19369,55,55,0
965000,974000,19370,65,65,0
973000,974000,19371,53,53,0
981000,974000,19372,28,28,0
-43000,966000,19540,42,0,42
-35000,966000,19541,72,0,72
-27000,966000,19542,63,0,63
-19000,966000,19543,87,1,86
-11000,966000,19544,80,1,79
-3000,966000,19545,67,0,67
5000,966000,19546,71,0,71
13000,966000,19547,61,0,61
21000,966000,19548,59,0,59
29000,966000,19549,63,0,63
37000,966000,19550,65,0,65
45000,966000,19551,74,0,74
53000,966000,19552,68,9,59
61000,966000,19553,68,14,54
69000,966000,19554,71,0,71
77000,966000,19555,71,0,71
85000,966000,19556,67,0,67
93000,966000,19557,58,0,58
101000,966000,19558,55,0,55
109000,966000,19559,51,0,51
117000,966000,19560,63,0,63
125000,966000,19561,60,4,56
133000,966000,19562,67,4,63
141000,966000,19563,73,54,19
149000,966000,19564,74,66,8
157000,966000,19565,68,68,0
165000,966000,19566,74,74,0
173000,966000,19567,68,67,1
181000,966000,19568,70,69,1
189000,966000,19569,61,38,23
197000,966000,19570,59,36,23
205000,966000,19571,52,46,6
213000,966000,19572,46,27,19
221000,966000,19573,66,66,0
229000,966000,19574,66,63,3
237000,966000,19575,69,34,35
245000,966000,19576,63,20,43
253000,966000,19577,43,40,3
261000,966000,19578,60,27,33
269000,966000,19579,67,18,49
277000,966000,19580,75,32,43
285000,966000,19581,76,68,8
293000,966000,19582,74,74,0
301000,966000,19583,75,75,0
309000,966000,19584,75,75,0
317000,966000,19585,72,70,2
325000,966000,19586,74,36,38
333000,966000,19587,73,36,37
341000,966000,19588,73,13,60
349000,966000,19589,62,33,29
357000,966000,19590,67,57,10
365000,966000,19591,66,56,10
373000,966000,19592,65,65,0
381000,966000,19593,74,74,0
389000,966000,19594,73,73,0
397000,966000,19595,70,70,0
405000,966000,19596,75,75,0
413000,966000,19597,73,73,0
421000,966000,19598,74,74,0
429000,966000,19599,74,74,0
437000,966000,19600,72,72,0
445000,966000,19601,76,76,0
453000,966000,19602,73,73,0
461000,966000,19603,81,81,0
469000,966000,19604,74,74,0
477000,966000,19605,70,70,0
485000,966000,19606,76,76,0
493000,966000,19607,76,76,0
501000,966000,19608,81,80,1
509000,966000,19609,57,57,0
517000,966000,19610,76,76,0
525000,966000,19611,74,74,0
533000,966000,19612,68,68,0
541000,966000,19613,72,72,0
549000,966000,19614,73,73,0
557000,966000,19615,65,65,0
565000,966000,19616,72,72,0
573000,966000,19617,67,67,0
581000,966000,19618,68,68,0
589000,966000,19619,72,72,0
597000,966000,19620,73,73,0
605000,966000,19621,73,73,0
613000,966000,19622,71,71,0
621000,966000,19623,76,76,0
629000,966000,19624,67,67,0
637000,966000,19625,80,80,0
645000,966000,19626,74,74,0
653000,966000,19627,71,71,0
661000,966000,19628,35,35,0
669000,966000,19629,1,1,0
677000,966000,19630,8,8,0
685000,966000,19631,2,2,0
693000,966000,19632,16,16,0
701000,966000,19633,45,45,0
709000,966000,19634,6,6,0
821000,966000,19648,2,2,0
829000,966000,19649,5,5,0
837000,966000,19650,68,68,0
845000,966000,19651,60,60,0
853000,966000,19652,35,35,0
861000,966000,19653,49,49,0
869000,966000,19654,59,59,0
877000,966000,19655,59,59,0
885000,966000,19656,71,71,0
893000,966000,19657,65,65,0
901000,966000,19658,68,68,0
909000,966000,19659,71,71,0
917000,966000,19660,79,79,0
925000,966000,19661,74,74,0
933000,966000,19662,74,74,0
941000,966000,19663,67,67,0
949000,966000,19664,66,65,1
957000,966000,19665,68,68,0
965000,966000,19666,71,71,0
973000,966000,19667,71,71,0
981000,966000,19668,53,53,0
989000,966000,19669,21,21,0
-43000,958000,19836,55,0,55
-35000,958000,19837,58,0,58
-27000,958000,19838,69,0,69
-19000,958000,19839,72,0,72
-11000,958000,19840,76,0,76
-3000,958000,19841,73,0,73
5000,958000,19842,71,0,71
13000,958000,19843,70,0,70
21000,958000,19844,70,0,70
29000,958000,19845,61,0,61
37000,958000,19846,58,0,58
45000,958000,19847,66,0,66
53000,958000,19848,63,0,63
61000,958000,19849,62,10,52
69000,958000,19850,70,11,59
77000,958000,19851,69,3,66
85000,958000,19852,66,0,66
93000,958000,19853,68,0,68
101000,958000,19854,61,0,61
109000,958000,19855,62,0,62
117000,958000,19856,64,0,64
125000,958000,19857,71,0,71
133000,958000,19858,55,11,44
141000,958000,19859,62,62,0
149000,958000,19860,62,62,0
157000,958000,19861,69,69,0
165000,958000,19862,76,75,1
173000,958000,19863,66,62,4
181000,958000,19864,64,54,10
189000,958000,19865,68,68,0
197000,958000,19866,65,60,5
205000,958000,19867,64,54,10
213000,958000,19868,75,53,22
221000,958000,19869,80,61,19
229000,958000,19870,71,45,26
237000,958000,19871,64,35,29
245000,958000,19872,64,26,38
253000,958000,19873,57,42,15
261000,958000,19874,63,52,11
269000,958000,19875,69,69,0
277000,958000,19876,70,68,2
285000,958000,19877,78,78,0
293000,958000,19878,69,69,0
301000,958000,19879,74,74,0
309000,958000,19880,76,76,0
317000,958000,19881,71,60,11
325000,958000,19882,72,44,28
333000,958000,19883,64,38,26
341000,958000,19884,65,28,37
349000,958000,19885,66,47,19
357000,958000,19886,67,65,2
365000,958000,19887,68,59,9
373000,958000,19888,70,69,1
381000,958000,19889,73,73,0
389000,958000,19890,73,73,0
397000,958000,19891,75,75,0
405000,958000,19892,74,74,0
413000,958000,19893,74,74,0
421000,958000,19894,72,72,0
429000,958000,19895,73,73,0
437000,958000,19896,79,79,0
445000,958000,19897,74,74,0
453000,958000,19898,78,78,0
461000,958000,19899,79,79,0
469000,958000,19900,74,74,0
477000,958000,19901,72,72,0
485000,958000,19902,78,78,0
493000,958000,19903,78,77,1
501000,958000,19904,73,73,0
509000,958000,19905,58,58,0
517000,958000,19906,72,72,0
525000,958000,19907,73,73,0
533000,958000,19908,76,76,0
541000,958000,19909,73,73,0
549000,958000,19910,75,75,0
557000,958000,19911,72,72,0
565000,958000,19912,73,73,0
573000,958000,19913,69,69,0
581000,958000,19914,72,72,0
589000,958000,19915,73,73,0
597000,958000,19916,73,73,0
605000,958000,19917,78,78,0
613000,958000,19918,79,79,0
621000,958000,19919,78,78,0
629000,958000,19920,72,72,0
637000,958000,19921,74,74,0
645000,958000,19922,79,77,2
653000,958000,19923,68,66,2
661000,958000,19924,8,8,0
685000,958000,19927,28,28,0
693000,958000,19928,59,59,0
701000,958000,19929,22,22,0
781000,958000,19939,23,23,0
789000,958000,19940,1,1,0
813000,958000,19943,25,25,0
821000,958000,19944,10,10,0
837000,958000,19946,59,59,0
845000,958000,19947,80,80,0
853000,958000,19948,63,63,0
861000,958000,19949,64,64,0
869000,958000,19950,69,69,0
877000,958000,19951,72,72,0
885000,958000,19952,83,83,0
893000,958000,19953,79,79,0
901000,958000,19954,84,84,0
909000,958000,19955,98,98,0
917000,958000,19956,86,86,0
925000,958000,19957,83,82,1
933000,958000,19958,72,72,0
941000,958000,19959,84,84,0
949000,958000,19960,86,86,0
957000,958000,19961,73,73,0
965000,958000,19962,78,78,0
973000,958000,19963,79,79,0
981000,958000,19964,65,65,0
989000,958000,19965,47,47,0
-43000,950000,20132,69,0,69
-35000,950000,20133,69,0,69
-27000,950000,20134,65,0,65
-19000,950000,20135,65,0,65
-11000,950000,20136,68,1,67
-3000,950000,20137,71,5,66
5000,950000,20138,71,1,70
13000,950000,20139,68,0,68
21000,950000,20140,72,0,72
29000,950000,20141,64,0,64
37000,950000,20142,57,0,57
45000,950000,20143,66,0,66
53000,950000,20144,63,0,63
61000,950000,20145,61,0,61
69000,950000,20146,73,6,67
77000,950000,20147,76,16,60
85000,950000,20148,75,2,73
93000,950000,20149,72,0,72
101000,950000,20150,69,0,69
109000,950000,20151,65,0,65
117000,950000,20152,68,0,68
125000,950000,20153,67,1,66
133000,950000,20154,66,2,64
141000,950000,20155,57,10,47
149000,950000,20156,68,60,8
157000,950000,20157,70,70,0
165000,950000,20158,73,68,5
173000,950000,20159,66,57,9
181000,950000,20160,68,64,4
189000,950000,20161,61,61,0
197000,950000,20162,66,63,3
205000,950000,20163,70,63,7
213000,950000,20164,73,20,53
221000,950000,20165,74,2,72
229000,950000,20166,74,9,65
237000,950000,20167,74,3,71
245000,950000,20168,66,28,38
253000,950000,20169,67,67,0
261000,950000,20170,52,52,0
269000,950000,20171,74,73,1
277000,950000,20172,73,73,0
285000,950000,20173,73,73,0
293000,950000,20174,73,73,0
301000,950000,20175,76,76,0
309000,950000,20176,66,65,1
317000,950000,20177,65,58,7
325000,950000,20178,68,64,4
333000,950000,20179,61,17,44
341000,950000,20180,64,41,23
349000,950000,20181,55,36,19
357000,950000,20182,68,52,16
365000,950000,20183,69,69,0
373000,950000,20184,68,68,0
381000,950000,20185,73,73,0
389000,950000,20186,75,75,0
397000,950000,20187,74,74,0
405000,950000,20188,74,74,0
413000,950000,20189,74,74,0
421000,950000,20190,72,72,0
429000,950000,20191,73,73,0
437000,950000,20192,75,75,0
445000,950000,20193,78,78,0
453000,950000,20194,75,75,0
461000,950000,20195,80,80,0
469000,950000,20196,78,78,0
477000,950000,20197,73,72,1
485000,950000,20198,75,75,0
493000,950000,20199,78,78,0
501000,950000,20200,73,73,0
509000,950000,20201,58,57,1
517000,950000,20202,71,71,0
525000,950000,20203,72,72,0
533000,950000,20204,74,74,0
541000,950000,20205,77,77,0
549000,950000,20206,74,74,0
557000,950000,20207,74,74,0
565000,950000,20208,74,74,0
573000,950000,20209,71,71,0
581000,950000,20210,68,68,0
589000,950000,20211,70,70,0
597000,950000,20212,74,74,0
605000,950000,20213,72,72,0
613000,950000,20214,71,71,0
621000,950000,20215,76,76,0
629000,950000,20216,69,69,0
637000,950000,20217,70,70,0
645000,950000,20218,72,71,1
653000,950000,20219,60,58,2
677000,950000,20222,8,8,0
685000,950000,20223,54,53,1
693000,950000,20224,50,50,0
701000,950000,20225,4,4,0
781000,950000,20235,36,36,0
789000,950000,20236,2,2,0
805000,950000,20238,8,8,0
813000,950000,20239,47,47,0
837000,950000,20242,50,50,0
845000,950000,20243,72,72,0
853000,950000,20244,87,87,0
861000,950000,20245,76,76,0
869000,950000,20246,77,77,0
877000,950000,20247,86,86,0
885000,950000,20248,77,77,0
893000,950000,20249,71,71,0
901000,950000,20250,72,72,0
909000,950000,20251,78,78,0
917000,950000,20252,73,73,0
925000,950000,20253,73,73,0
933000,950000,20254,75,75,0
941000,950000,20255,70,70,0
949000,950000,20256,66,66,0
957000,950000,20257,36,35,1
965000,950000,20258,55,55,0
973000,950000,20259,69,69,0
981000,950000,20260,71,71,0
989000,950000,20261,63,63,0
997000,950000,20262,8,8,0
-51000,942000,20427,6,0,6
-43000,942000,20428,74,0,74
-35000,942000,20429,60,0,60
-27000,942000,20430,54,0,54
-19000,942000,20431,70,0,70
-11000,942000,20432,70,1,69
-3000,942000,20433,68,4,64
5000,942000,20434,74,0,74
13000,942000,20435,66,0,66
21000,942000,20436,72,0,72
29000,942000,20437,62,0,62
37000,942000,20438,55,0,55
45000,942000,20439,56,0,56
53000,942000,20440,67,0,67
61000,942000,20441,61,0,61
69000,942000,20442,59,0,59
77000,942000,20443,68,0,68
85000,942000,20444,69,11,58
93000,942000,20445,75,9,66
101000,942000,20446,73,0,73
109000,942000,20447,62,0,62
117000,942000,20448,65,0,65
125000,942000,20449,66,0,66
133000,942000,20450,67,0,67
141000,942000,20451,66,11,55
149000,942000,20452,68,49,19
157000,942000,20453,65,65,0
165000,942000,20454,72,72,0
173000,942000,20455,66,66,0
181000,942000,20456,72,70,2
189000,942000,20457,66,66,0
197000,942000,20458,66,63,3
205000,942000,20459,66,52,14
213000,942000,20460,70,7,63
221000,942000,20461,65,6,59
229000,942000,20462,69,23,46
237000,942000,20463,67,22,45
245000,942000,20464,78,59,19
253000,942000,20465,64,56,8
261000,942000,20466,61,58,3
269000,942000,20467,64,64,0
277000,942000,20468,74,74,0
285000,942000,20469,73,73,0
293000,942000,20470,71,71,0
301000,942000,20471,72,72,0
309000,942000,20472,64,63,1
317000,942000,20473,68,55,13
325000,942000,20474,70,38,32
333000,942000,20475,64,42,22
341000,942000,20476,65,37,28
349000,942000,20477,72,38,34
357000,942000,20478,69,15,54
365000,942000,20479,70,26,44
373000,942000,20480,67,55,12
381000,942000,20481,71,69,2
389000,942000,20482,73,72,1
397000,942000,20483,72,71,1
405000,942000,20484,73,73,0
413000,942000,20485,70,70,0
421000,942000,20486,71,71,0
429000,942000,20487,75,75,0
437000,942000,20488,74,74,0
445000,942000,20489,77,77,0
453000,942000,20490,74,74,0
461000,942000,20491,77,77,0
469000,942000,20492,78,78,0
477000,942000,20493,75,75,0
485000,942000,20494,70,70,0
493000,942000,20495,77,77,0
501000,942000,20496,78,77,1
509000,942000,20497,55,55,0
517000,942000,20498,67,67,0
525000,942000,20499,70,70,0
533000,942000,20500,74,74,0
541000,942000,20501,75,75,0
549000,942000,20502,72,72,0
557000,942000,20503,73,72,1
565000,942000,20504,73,73,0
573000,942000,20505,67,64,3
581000,942000,20506,64,64,0
589000,942000,20507,64,64,0
597000,942000,20508,76,76,0
605000,942000,20509,76,76,0
613000,942000,20510,71,71,0
621000,942000,20511,72,72,0
629000,942000,20512,73,73,0
637000,942000,20513,71,70,1
645000,942000,20514,29,28,1
653000,942000,20515,18,9,9
677000,942000,20518,35,35,0
685000,942000,20519,61,60,1
693000,942000,20520,16,16,0
773000,942000,20530,22,22,0
805000,942000,20534,55,55,0
813000,942000,20535,45,45,0
829000,942000,20537,8,8,0
837000,942000,20538,47,47,0
845000,942000,20539,70,70,0
853000,942000,20540,74,74,0
861000,942000,20541,78,78,0
869000,942000,20542,72,72,0
877000,942000,20543,85,85,0
885000,942000,20544,86,86,0
893000,942000,20545,80,80,0
901000,942000,20546,76,76,0
909000,942000,20547,86,86,0
917000,942000,20548,76,76,0
925000,942000,20549,77,77,0
933000,942000,20550,70,70,0
941000,942000,20551,68,68,0
949000,942000,20552,76,76,0
957000,942000,20553,65,65,0
965000,942000,20554,68,68,0
973000,942000,20555,72,72,0
981000,942000,20556,63,63,0
989000,942000,20557,16,16,0
997000,942000,20558,16,15,1
-51000,934000,20723,19,0,19
-43000,934000,20724,72,0,72
-35000,934000,20725,72,0,72
-27000,934000,20726,67,0,67
-19000,934000,20727,67,1,66
-11000,934000,20728,72,3,69
-3000,934000,20729,64,1,63
5000,934000,20730,65,1,64
13000,934000,20731,72,1,71
21000,934000,20732,79,0,79
29000,934000,20733,66,0,66
37000,934000,20734,61,0,61
45000,934000,20735,67,0,67
53000,934000,20736,67,0,67
61000,934000,20737,65,0,65
69000,934000,20738,62,0,62
77000,934000,20739,66,0,66
85000,934000,20740,59,0,59
93000,934000,20741,67,18,49
101000,934000,20742,63,15,48
109000,934000,20743,67,2,65
117000,934000,20744,69,0,69
125000,934000,20745,71,0,71
133000,934000,20746,67,3,64
141000,934000,20747,75,4,71
149000,934000,20748,66,39,27
157000,934000,20749,70,57,13
165000,934000,20750,73,73,0
173000,934000,20751,68,68,0
181000,934000,20752,64,64,0
189000,934000,20753,60,60,0
197000,934000,20754,74,74,0
205000,934000,20755,69,65,4
213000,934000,20756,61,28,33
221000,934000,20757,68,0,68
229000,934000,20758,74,4,70
237000,934000,20759,70,8,62
245000,934000,20760,72,50,22
253000,934000,20761,65,56,9
261000,934000,20762,59,56,3
269000,934000,20763,49,38,11
277000,934000,20764,67,67,0
285000,934000,20765,64,61,3
293000,934000,20766,63,63,0
301000,934000,20767,70,68,2
309000,934000,20768,65,53,12
317000,934000,20769,66,51,15
325000,934000,20770,69,60,9
333000,934000,20771,71,68,3
341000,934000,20772,70,57,13
349000,934000,20773,66,36,30
357000,934000,20774,74,6,68
365000,934000,20775,71,4,67
373000,934000,20776,70,11,59
381000,934000,20777,69,65,4
389000,934000,20778,71,70,1
397000,934000,20779,74,74,0
405000,934000,20780,72,72,0
413000,934000,20781,73,73,0
421000,934000,20782,73,73,0
429000,934000,20783,77,76,1
437000,934000,20784,72,72,0
445000,934000,20785,73,73,0
453000,934000,20786,71,71,0
461000,934000,20787,79,79,0
469000,934000,20788,77,77,0
477000,934000,20789,78,78,0
485000,934000,20790,69,69,0
493000,934000,20791,69,69,0
501000,934000,20792,76,76,0
509000,934000,20793,54,53,1
517000,934000,20794,67,67,0
525000,934000,20795,72,72,0
533000,934000,20796,74,74,0
541000,934000,20797,73,73,0
549000,934000,20798,72,72,0
557000,934000,20799,70,69,1
565000,934000,20800,66,66,0
573000,934000,20801,64,64,0
581000,934000,20802,61,61,0
589000,934000,20803,72,72,0
597000,934000,20804,67,67,0
605000,934000,20805,79,79,0
613000,934000,20806,81,81,0
621000,934000,20807,74,73,1
629000,934000,20808,83,83,0
637000,934000,20809,31,29,2
661000,934000,20812,2,2,0
669000,934000,20813,11,11,0
677000,934000,20814,61,61,0
685000,934000,20815,54,54,0
693000,934000,20816,3,3,0
781000,934000,20827,1,1,0
789000,934000,20828,42,42,0
797000,934000,20829,39,39,0
805000,934000,20830,72,72,0
813000,934000,20831,32,32,0
821000,934000,20832,24,24,0
829000,934000,20833,14,14,0
837000,934000,20834,41,41,0
845000,934000,20835,61,61,0
853000,934000,20836,69,69,0
861000,934000,20837,66,66,0
869000,934000,20838,68,68,0
877000,934000,20839,82,82,0
885000,934000,20840,62,62,0
893000,934000,20841,75,75,0
901000,934000,20842,69,69,0
909000,934000,20843,88,88,0
917000,934000,20844,71,71,0
925000,934000,20845,63,63,0
933000,934000,20846,61,61,0
941000,934000,20847,52,52,0
949000,934000,20848,59,59,0
957000,934000,20849,63,63,0
965000,934000,20850,60,60,0
973000,934000,20851,69,69,0
981000,934000,20852,56,56,0
989000,934000,20853,1,1,0
-51000,926000,21019,35,0,35
-43000,926000,21020,72,0,72
-35000,926000,21021,69,0,69
-27000,926000,21022,73,0,73
-19000,926000,21023,79,0,79
-11000,926000,21024,72,0,72
-3000,926000,21025,75,0,75
5000,926000,21026,58,0,58
13000,926000,21027,65,0,65
21000,926000,21028,73,0,73
29000,926000,21029,73,0,73
37000,926000,21030,73,0,73
45000,926000,21031,72,0,72
53000,926000,21032,65,0,65
61000,926000,21033,76,0,76
69000,926000,21034,69,0,69
77000,926000,21035,69,0,69
85000,926000,21036,62,1,61
93000,926000,21037,66,4,62
101000,926000,21038,65,9,56
109000,926000,21039,70,22,48
117000,926000,21040,60,0,60
125000,926000,21041,63,1,62
133000,926000,21042,64,0,64
141000,926000,21043,51,23,28
149000,926000,21044,63,38,25
157000,926000,21045,70,43,27
165000,926000,21046,70,70,0
173000,926000,21047,70,70,0
181000,926000,21048,71,71,0
189000,926000,21049,65,65,0
197000,926000,21050,62,62,0
205000,926000,21051,73,73,0
213000,926000,21052,75,55,20
221000,926000,21053,84,2,82
229000,926000,21054,71,10,61
237000,926000,21055,59,46,13
245000,926000,21056,61,39,22
253000,926000,21057,67,35,32
261000,926000,21058,69,56,13
269000,926000,21059,68,63,5
277000,926000,21060,45,44,1
285000,926000,21061,42,40,2
293000,926000,21062,55,47,8
301000,926000,21063,60,56,4
309000,926000,21064,69,53,16
317000,926000,21065,70,65,5
325000,926000,21066,67,62,5
333000,926000,21067,67,52,15
341000,926000,21068,67,44,23
349000,926000,21069,74,28,46
357000,926000,21070,74,6,68
365000,926000,21071,73,10,63
373000,926000,21072,74,12,62
381000,926000,21073,67,50,17
389000,926000,21074,64,61,3
397000,926000,21075,69,69,0
405000,926000,21076,73,73,0
413000,926000,21077,71,71,0
421000,926000,21078,72,72,0
429000,926000,21079,73,73,0
437000,926000,21080,73,73,0
445000,926000,21081,75,75,0
453000,926000,21082,76,76,0
461000,926000,21083,76,75,1
469000,926000,21084,72,72,0
477000,926000,21085,75,70,5
485000,926000,21086,74,73,1
493000,926000,21087,72,72,0
501000,926000,21088,72,72,0
509000,926000,21089,58,58,0
517000,926000,21090,75,75,0
525000,926000,21091,70,70,0
533000,926000,21092,74,74,0
541000,926000,21093,69,69,0
549000,926000,21094,63,63,0
557000,926000,21095,71,71,0
565000,926000,21096,72,72,0
573000,926000,21097,66,66,0
581000,926000,21098,48,48,0
589000,926000,21099,59,59,0
597000,926000,21100,69,69,0
605000,926000,21101,71,71,0
613000,926000,21102,75,75,0
621000,926000,21103,72,72,0
629000,926000,21104,61,60,1
637000,926000,21105,2,2,0
653000,926000,21107,20,20,0
661000,926000,21108,56,55,1
669000,926000,21109,53,53,0
677000,926000,21110,44,44,0
685000,926000,21111,12,12,0
781000,926000,21123,44,44,0
789000,926000,21124,56,56,0
797000,926000,21125,77,77,0
805000,926000,21126,53,53,0
813000,926000,21127,16,16,0
821000,926000,21128,32,32,0
829000,926000,21129,21,21,0
837000,926000,21130,44,44,0
845000,926000,21131,85,85,0
853000,926000,21132,80,80,0
861000,926000,21133,73,73,0
869000,926000,21134,81,81,0
877000,926000,21135,83,83,0
885000,926000,21136,77,77,0
893000,926000,21137,77,77,0
901000,926000,21138,72,72,0
909000,926000,21139,75,75,0
917000,926000,21140,61,61,0
925000,926000,21141,65,65,0
933000,926000,21142,68,68,0
941000,926000,21143,65,65,0
949000,926000,21144,60,60,0
957000,926000,21145,71,71,0
965000,926000,21146,67,67,0
973000,926000,21147,69,69,0
981000,926000,21148,73,73,0
989000,926000,21149,36,36,0
997000,926000,21150,2,2,0
-51000,918000,21315,46,0,46
-43000,918000,21316,72,0,72
-35000,918000,21317,73,0,73
-27000,918000,21318,75,0,75
-19000,918000,21319,79,0,79
-11000,918000,21320,69,0,69
-3000,918000,21321,61,1,60
5000,918000,21322,62,1,61
13000,918000,21323,54,3,51
21000,918000,21324,62,1,61
29000,918000,21325,79,0,79
37000,918000,21326,77,0,77
45000,918000,21327,85,0,85
53000,918000,21328,85,1,84
61000,918000,21329,83,0,83
69000,918000,21330,78,0,78
77000,918000,21331,75,3,72
85000,918000,21332,70,6,64
93000,918000,21333,69,8,61
101000,918000,21334,63,10,53
109000,918000,21335,71,20,51
117000,918000,21336,73,19,54
125000,918000,21337,32,5,27
133000,918000,21338,51,8,43
141000,918000,21339,66,11,55
149000,918000,21340,62,39,23
157000,918000,21341,67,67,0
165000,918000,21342,67,67,0
173000,918000,21343,68,68,0
181000,918000,21344,71,71,0
189000,918000,21345,69,69,0
197000,918000,21346,55,54,1
205000,918000,21347,72,70,2
213000,918000,21348,70,31,39
221000,918000,21349,79,3,76
229000,918000,21350,73,26,47
237000,918000,21351,64,35,29
245000,918000,21352,57,42,15
253000,918000,21353,65,47,18
261000,918000,21354,64,53,11
269000,918000,21355,69,62,7
277000,918000,21356,77,77,0
285000,918000,21357,42,40,2
293000,918000,21358,56,54,2
301000,918000,21359,64,61,3
309000,918000,21360,64,56,8
317000,918000,21361,70,65,5
325000,918000,21362,73,70,3
333000,918000,21363,70,62,8
341000,918000,21364,68,51,17
349000,918000,21365,72,44,28
357000,918000,21366,71,40,31
365000,918000,21367,71,43,28
373000,918000,21368,74,35,39
381000,918000,21369,70,29,41
389000,918000,21370,72,43,29
397000,918000,21371,73,70,3
405000,918000,21372,74,74,0
413000,918000,21373,74,74,0
421000,918000,21374,74,74,0
429000,918000,21375,71,69,2
437000,918000,21376,72,72,0
445000,918000,21377,73,73,0
453000,918000,21378,76,76,0
461000,918000,21379,80,80,0
469000,918000,21380,75,75,0
477000,918000,21381,78,78,0
485000,918000,21382,76,76,0
493000,918000,21383,60,60,0
501000,918000,21384,76,75,1
509000,918000,21385,55,55,0
517000,918000,21386,71,71,0
525000,918000,21387,66,66,0
533000,918000,21388,73,73,0
541000,918000,21389,69,68,1
549000,918000,21390,71,71,0
557000,918000,21391,71,71,0
565000,918000,21392,67,67,0
573000,918000,21393,69,69,0
581000,918000,21394,69,69,0
589000,918000,21395,67,66,1
597000,918000,21396,72,72,0
605000,918000,21397,69,69,0
613000,918000,21398,62,62,0
621000,918000,21399,81,81,0
629000,918000,21400,19,16,3
645000,918000,21402,6,6,0
653000,918000,21403,65,65,0
661000,918000,21404,67,67,0
669000,918000,21405,62,62,0
677000,918000,21406,35,35,0
781000,918000,21419,83,83,0
789000,918000,21420,72,72,0
797000,918000,21421,81,81,0
805000,918000,21422,76,76,0
813000,918000,21423,27,27,0
821000,918000,21424,26,26,0
829000,918000,21425,51,51,0
837000,918000,21426,63,63,0
845000,918000,21427,70,70,0
853000,918000,21428,66,66,0
861000,918000,21429,65,65,0
869000,918000,21430,64,64,0
877000,918000,21431,80,80,0
885000,918000,21432,69,69,0
893000,918000,21433,72,72,0
901000,918000,21434,66,66,0
909000,918000,21435,78,78,0
917000,918000,21436,83,83,0
925000,918000,21437,81,81,0
933000,918000,21438,81,81,0
941000,918000,21439,75,75,0
949000,918000,21440,67,67,0
957000,918000,21441,73,73,0
965000,918000,21442,70,70,0
973000,918000,21443,53,53,0
981000,918000,21444,75,75,0
989000,918000,21445,82,82,0
997000,918000,21446,23,23,0
-51000,910000,21611,58,0,58
-43000,910000,21612,74,0,74
-35000,910000,21613,75,0,75
-27000,910000,21614,74,0,74
-19000,910000,21615,77,0,77
-11000,910000,21616,70,0,70
-3000,910000,21617,70,0,70
5000,910000,21618,71,3,68
13000,910000,21619,67,0,67
21000,910000,21620,62,1,61
29000,910000,21621,75,0,75
37000,910000,21622,75,0,75
45000,910000,21623,73,0,73
53000,910000,21624,81,0,81
61000,910000,21625,76,0,76
69000,910000,21626,74,0,74
77000,910000,21627,70,0,70
85000,910000,21628,81,0,81
93000,910000,21629,60,0,60
101000,910000,21630,72,0,72
109000,910000,21631,70,2,68
117000,910000,21632,70,11,59
125000,910000,21633,62,28,34
133000,910000,21634,60,10,50
141000,910000,21635,65,27,38
149000,910000,21636,71,51,20
157000,910000,21637,59,59,0
165000,910000,21638,52,52,0
173000,910000,21639,68,68,0
181000,910000,21640,72,72,0
189000,910000,21641,62,62,0
197000,910000,21642,60,53,7
205000,910000,21643,69,58,11
213000,910000,21644,71,18,53
221000,910000,21645,73,15,58
229000,910000,21646,68,46,22
237000,910000,21647,64,30,34
245000,910000,21648,54,39,15
253000,910000,21649,57,42,15
261000,910000,21650,65,16,49
269000,910000,21651,72,37,35
277000,910000,21652,68,46,22
285000,910000,21653,65,59,6
293000,910000,21654,51,48,3
301000,910000,21655,55,53,2
309000,910000,21656,68,67,1
317000,910000,21657,67,65,2
325000,910000,21658,66,64,2
333000,910000,21659,70,57,13
341000,910000,21660,67,58,9
349000,910000,21661,73,19,54
357000,910000,21662,72,47,25
365000,910000,21663,69,26,43
373000,910000,21664,74,15,59
381000,910000,21665,71,10,61
389000,910000,21666,73,27,46
397000,910000,21667,71,69,2
405000,910000,21668,73,72,1
413000,910000,21669,70,70,0
421000,910000,21670,72,72,0
429000,910000,21671,71,71,0
437000,910000,21672,75,74,1
445000,910000,21673,72,71,1
453000,910000,21674,71,71,0
461000,910000,21675,80,80,0
469000,910000,21676,70,70,0
477000,910000,21677,76,76,0
485000,910000,21678,71,71,0
493000,910000,21679,63,61,2
501000,910000,21680,69,67,2
509000,910000,21681,58,58,0
517000,910000,21682,71,71,0
525000,910000,21683,74,74,0
533000,910000,21684,73,73,0
541000,910000,21685,74,74,0
549000,910000,21686,73,73,0
557000,910000,21687,74,74,0
565000,910000,21688,62,62,0
573000,910000,21689,69,69,0
581000,910000,21690,56,55,1
589000,910000,21691,67,67,0
597000,910000,21692,72,72,0
605000,910000,21693,72,72,0
613000,910000,21694,73,73,0
621000,910000,21695,56,55,1
629000,910000,21696,1,0,1
637000,910000,21697,1,1,0
645000,910000,21698,39,39,0
653000,910000,21699,73,73,0
661000,910000,21700,66,66,0
669000,910000,21701,62,61,1
677000,910000,21702,14,14,0
765000,910000,21713,14,14,0
773000,910000,21714,33,33,0
781000,910000,21715,66,66,0
789000,910000,21716,69,69,0
797000,910000,21717,74,74,0
805000,910000,21718,55,55,0
813000,910000,21719,67,67,0
821000,910000,21720,60,60,0
829000,910000,21721,72,72,0
837000,910000,21722,80,80,0
845000,910000,21723,72,72,0
853000,910000,21724,67,67,0
861000,910000,21725,69,68,1
869000,910000,21726,72,72,0
877000,910000,21727,81,81,0
885000,910000,21728,73,73,0
893000,910000,21729,70,70,0
901000,910000,21730,77,77,0
909000,910000,21731,70,70,0
917000,910000,21732,65,65,0
925000,910000,21733,72,72,0
933000,910000,21734,73,73,0
941000,910000,21735,67,67,0
949000,910000,21736,65,65,0
957000,910000,21737,60,60,0
965000,910000,21738,68,68,0
973000,910000,21739,55,55,0
981000,910000,21740,69,69,0
989000,910000,21741,71,71,0
997000,910000,21742,30,30,0
-51000,902000,21907,70,0,70
-43000,902000,21908,70,0,70
-35000,902000,21909,73,0,73
-27000,902000,21910,76,0,76
-19000,902000,21911,78,1,77
-11000,902000,21912,72,0,72
-3000,902000,21913,70,0,70
5000,902000,21914,71,0,71
13000,902000,21915,74,0,74
21000,902000,21916,61,0,61
29000,902000,21917,71,0,71
37000,902000,21918,69,0,69
45000,902000,21919,71,0,71
53000,902000,21920,74,0,74
61000,902000,21921,76,0,76
69000,902000,21922,79,0,79
77000,902000,21923,78,0,78
85000,902000,21924,71,0,71
93000,902000,21925,67,0,67
101000,902000,21926,70,1,69
109000,902000,21927,58,4,54
117000,902000,21928,74,4,70
125000,902000,21929,65,2,63
133000,902000,21930,65,24,41
141000,902000,21931,67,57,10
149000,902000,21932,68,66,2
157000,902000,21933,56,56,0
165000,902000,21934,56,56,0
173000,902000,21935,60,59,1
181000,902000,21936,58,49,9
189000,902000,21937,62,29,33
197000,902000,21938,59,10,49
205000,902000,21939,70,41,29
213000,902000,21940,72,7,65
221000,902000,21941,75,20,55
229000,902000,21942,67,12,55
237000,902000,21943,73,7,66
245000,902000,21944,72,8,64
253000,902000,21945,67,13,54
261000,902000,21946,65,30,35
269000,902000,21947,67,49,18
277000,902000,21948,63,42,21
285000,902000,21949,71,68,3
293000,902000,21950,68,62,6
301000,902000,21951,68,61,7
309000,902000,21952,58,43,15
317000,902000,21953,72,68,4
325000,902000,21954,67,54,13
333000,902000,21955,68,50,18
341000,902000,21956,67,37,30
349000,902000,21957,71,46,25
357000,902000,21958,70,69,1
365000,902000,21959,71,18,53
373000,902000,21960,68,20,48
381000,902000,21961,74,15,59
389000,902000,21962,69,43,26
397000,902000,21963,69,62,7
405000,902000,21964,72,71,1
413000,902000,21965,68,64,4
421000,902000,21966,69,67,2
429000,902000,21967,59,59,0
437000,902000,21968,77,77,0
445000,902000,21969,73,73,0
453000,902000,21970,69,69,0
461000,902000,21971,75,75,0
469000,902000,21972,71,71,0
477000,902000,21973,74,74,0
485000,902000,21974,75,75,0
493000,902000,21975,72,72,0
501000,902000,21976,66,66,0
509000,902000,21977,53,53,0
517000,902000,21978,73,73,0
525000,902000,21979,75,75,0
533000,902000,21980,71,71,0
541000,902000,21981,72,71,1
549000,902000,21982,73,73,0
557000,902000,21983,73,73,0
565000,902000,21984,71,70,1
573000,902000,21985,70,70,0
581000,902000,21986,65,63,2
589000,902000,21987,68,68,0
597000,902000,21988,71,71,0
605000,902000,21989,55,55,0
613000,902000,21990,58,58,0
621000,902000,21991,38,34,4
629000,902000,21992,6,6,0
637000,902000,21993,73,73,0
645000,902000,21994,74,74,0
653000,902000,21995,67,67,0
661000,902000,21996,69,69,0
669000,902000,21997,32,32,0
765000,902000,22009,32,32,0
773000,902000,22010,51,51,0
781000,902000,22011,66,66,0
789000,902000,22012,66,66,0
797000,902000,22013,80,80,0
805000,902000,22014,64,64,0
813000,902000,22015,69,69,0
821000,902000,22016,59,59,0
829000,902000,22017,70,70,0
837000,902000,22018,71,71,0
845000,902000,22019,69,69,0
853000,902000,22020,72,72,0
861000,902000,22021,72,72,0
869000,902000,22022,73,73,0
877000,902000,22023,69,69,0
885000,902000,22024,75,75,0
893000,902000,22025,73,73,0
901000,902000,22026,72,72,0
909000,902000,22027,65,65,0
917000,902000,22028,71,71,0
925000,902000,22029,74,74,0
933000,902000,22030,71,71,0
941000,902000,22031,66,66,0
949000,902000,22032,64,64,0
957000,902000,22033,59,59,0
965000,902000,22034,69,69,0
973000,902000,22035,68,68,0
981000,902000,22036,64,64,0
989000,902000,22037,72,72,0
997000,902000,22038,38,38,0
-59000,894000,22202,10,0,10
-51000,894000,22203,73,0,73
-43000,894000,22204,74,0,74
-35000,894000,22205,76,0,76
-27000,894000,22206,80,0,80
-19000,894000,22207,74,0,74
-11000,894000,22208,69,0,69
-3000,894000,22209,68,0,68
5000,894000,22210,65,0,65
13000,894000,22211,68,0,68
21000,894000,22212,74,0,74
29000,894000,22213,68,1,67
37000,894000,22214,71,0,71
45000,894000,22215,68,0,68
53000,894000,22216,65,0,65
61000,894000,22217,67,0,67
69000,894000,22218,72,0,72
77000,894000,22219,77,0,77
85000,894000,22220,71,0,71
93000,894000,22221,66,0,66
101000,894000,22222,71,1,70
109000,894000,22223,67,8,59
117000,894000,22224,66,6,60
125000,894000,22225,60,4,56
133000,894000,22226,64,36,28
141000,894000,22227,66,54,12
149000,894000,22228,68,49,19
157000,894000,22229,66,62,4
165000,894000,22230,65,55,10
173000,894000,22231,57,42,15
181000,894000,22232,60,37,23
189000,894000,22233,70,43,27
197000,894000,22234,66,60,6
205000,894000,22235,75,54,21
213000,894000,22236,70,15,55
221000,894000,22237,79,0,79
229000,894000,22238,69,2,67
237000,894000,22239,63,16,47
245000,894000,22240,69,33,36
253000,894000,22241,70,16,54
261000,894000,22242,79,47,32
269000,894000,22243,65,45,20
277000,894000,22244,69,60,9
285000,894000,22245,69,51,18
293000,894000,22246,70,69,1
301000,894000,22247,74,68,6
309000,894000,22248,63,46,17
317000,894000,22249,72,71,1
325000,894000,22250,61,55,6
333000,894000,22251,68,64,4
341000,894000,22252,65,39,26
349000,894000,22253,70,42,28
357000,894000,22254,67,53,14
365000,894000,22255,72,30,42
373000,894000,22256,72,44,28
381000,894000,22257,68,59,9
389000,894000,22258,68,56,12
397000,894000,22259,66,59,7
405000,894000,22260,67,60,7
413000,894000,22261,73,73,0
421000,894000,22262,70,70,0
429000,894000,22263,68,68,0
437000,894000,22264,74,73,1
445000,894000,22265,72,72,0
453000,894000,22266,67,67,0
461000,894000,22267,67,64,3
469000,894000,22268,72,68,4
477000,894000,22269,69,68,1
485000,894000,22270,63,62,1
493000,894000,22271,69,67,2
501000,894000,22272,72,69,3
509000,894000,22273,57,51,6
517000,894000,22274,67,66,1
525000,894000,22275,66,66,0
533000,894000,22276,69,68,1
541000,894000,22277,72,72,0
549000,894000,22278,70,70,0
557000,894000,22279,72,71,1
565000,894000,22280,75,75,0
573000,894000,22281,69,60,9
581000,894000,22282,60,60,0
589000,894000,22283,75,74,1
597000,894000,22284,63,63,0
605000,894000,22285,2,2,0
613000,894000,22286,13,13,0
621000,894000,22287,20,14,6
629000,894000,22288,51,47,4
637000,894000,22289,73,72,1
645000,894000,22290,77,77,0
653000,894000,22291,74,74,0
661000,894000,22292,64,63,1
669000,894000,22293,2,2,0
765000,894000,22305,34,34,0
773000,894000,22306,71,71,0
781000,894000,22307,63,63,0
789000,894000,22308,71,71,0
797000,894000,22309,59,59,0
805000,894000,22310,70,70,0
813000,894000,22311,71,71,0
821000,894000,22312,70,70,0
829000,894000,22313,71,71,0
837000,894000,22314,69,69,0
845000,894000,22315,79,79,0
853000,894000,22316,66,66,0
861000,894000,22317,70,70,0
869000,894000,22318,67,67,0
877000,894000,22319,75,75,0
885000,894000,22320,66,66,0
893000,894000,22321,58,58,0
901000,894000,22322,67,67,0
909000,894000,22323,68,68,0
917000,894000,22324,73,73,0
925000,894000,22325,71,71,0
933000,894000,22326,70,70,0
941000,894000,22327,59,59,0
949000,894000,22328,65,65,0
957000,894000,22329,63,63,0
965000,894000,22330,66,66,0
973000,894000,22331,71,71,0
981000,894000,22332,64,64,0
989000,894000,22333,70,70,0
997000,894000,22334,18,18,0
-59000,886000,22498,26,0,26
-51000,886000,22499,72,0,72
-43000,886000,22500,74,0,74
-35000,886000,22501,72,0,72
-27000,886000,22502,75,0,75
-19000,886000,22503,76,0,76
-11000,886000,22504,72,0,72
-3000,886000,22505,72,0,72
5000,886000,22506,71,0,71
13000,886000,22507,71,0,71
21000,886000,22508,77,0,77
29000,886000,22509,70,0,70
37000,886000,22510,72,0,72
45000,886000,22511,75,2,73
53000,886000,22512,67,0,67
61000,886000,22513,65,0,65
69000,886000,22514,72,0,72
77000,886000,22515,74,0,74
85000,886000,22516,69,0,69
93000,886000,22517,60,0,60
101000,886000,22518,72,1,71
109000,886000,22519,75,0,75
117000,886000,22520,72,9,63
125000,886000,22521,69,7,62
133000,886000,22522,67,19,48
141000,886000,22523,61,33,28
149000,886000,22524,73,16,57
157000,886000,22525,76,29,47
165000,886000,22526,59,39,20
173000,886000,22527,62,18,44
181000,886000,22528,60,13,47
189000,886000,22529,51,21,30
197000,886000,22530,64,13,51
205000,886000,22531,71,44,27
213000,886000,22532,55,25,30
221000,886000,22533,65,21,44
229000,886000,22534,68,0,68
237000,886000,22535,68,15,53
245000,886000,22536,66,48,18
253000,886000,22537,62,39,23
261000,886000,22538,83,38,45
269000,886000,22539,74,23,51
277000,886000,22540,77,12,65
285000,886000,22541,72,18,54
293000,886000,22542,75,55,20
301000,886000,22543,72,69,3
309000,886000,22544,58,54,4
317000,886000,22545,57,52,5
325000,886000,22546,52,47,5
333000,886000,22547,61,60,1
341000,886000,22548,59,55,4
349000,886000,22549,55,31,24
357000,886000,22550,67,49,18
365000,886000,22551,66,56,10
373000,886000,22552,64,41,23
381000,886000,22553,73,61,12
389000,886000,22554,72,70,2
397000,886000,22555,63,60,3
405000,886000,22556,68,68,0
413000,886000,22557,70,67,3
421000,886000,22558,70,70,0
429000,886000,22559,71,65,6
437000,886000,22560,71,55,16
445000,886000,22561,61,51,10
453000,886000,22562,67,65,2
461000,886000,22563,56,44,12
469000,886000,22564,64,53,11
477000,886000,22565,67,65,2
485000,886000,22566,59,57,2
493000,886000,22567,62,49,13
501000,886000,22568,68,60,8
509000,886000,22569,62,61,1
517000,886000,22570,70,70,0
525000,886000,22571,74,73,1
533000,886000,22572,72,70,2
541000,886000,22573,71,70,1
549000,886000,22574,65,65,0
557000,886000,22575,71,67,4
565000,886000,22576,71,70,1
573000,886000,22577,66,65,1
581000,886000,22578,62,60,2
589000,886000,22579,64,64,0
597000,886000,22580,40,40,0
605000,886000,22581,5,5,0
613000,886000,22582,32,32,0
621000,886000,22583,22,22,0
629000,886000,22584,65,65,0
637000,886000,22585,60,60,0
645000,886000,22586,74,74,0
653000,886000,22587,70,70,0
661000,886000,22588,46,46,0
765000,886000,22601,48,48,0
773000,886000,22602,74,74,0
781000,886000,22603,71,70,1
789000,886000,22604,65,65,0
797000,886000,22605,67,67,0
805000,886000,22606,68,68,0
813000,886000,22607,69,69,0
821000,886000,22608,68,68,0
829000,886000,22609,67,67,0
837000,886000,22610,69,69,0
845000,886000,22611,73,73,0
853000,886000,22612,73,73,0
861000,886000,22613,74,74,0
869000,886000,22614,63,63,0
877000,886000,22615,62,62,0
885000,886000,22616,73,73,0
893000,886000,22617,69,69,0
901000,886000,22618,69,69,0
909000,886000,22619,71,71,0
917000,886000,22620,68,68,0
925000,886000,22621,70,70,0
933000,886000,22622,73,73,0
941000,886000,22623,69,69,0
949000,886000,22624,77,77,0
957000,886000,22625,60,60,0
965000,886000,22626,70,70,0
973000,886000,22627,64,64,0
981000,886000,22628,79,79,0
989000,886000,22629,74,74,0
997000,886000,22630,10,10,0
-59000,878000,22794,37,0,37
-51000,878000,22795,73,0,73
-43000,878000,22796,74,0,74
-35000,878000,22797,72,0,72
-27000,878000,22798,78,0,78
-19000,878000,22799,73,0,73
-11000,878000,22800,70,0,70
-3000,878000,22801,70,0,70
5000,878000,22802,74,0,74
13000,878000,22803,71,0,71
21000,878000,22804,72,0,72
29000,878000,22805,74,0,74
37000,878000,22806,65,0,65
45000,878000,22807,66,0,66
53000,878000,22808,66,1,65
61000,878000,22809,74,0,74
69000,878000,22810,80,0,80
77000,878000,22811,73,1,72
85000,878000,22812,63,4,59
93000,878000,22813,65,1,64
101000,878000,22814,73,0,73
109000,878000,22815,76,0,76
117000,878000,22816,68,1,67
125000,878000,22817,68,20,48
133000,878000,22818,69,13,56
141000,878000,22819,68,0,68
149000,878000,22820,69,13,56
157000,878000,22821,70,6,64
165000,878000,22822,63,3,60
173000,878000,22823,69,10,59
181000,878000,22824,67,16,51
189000,878000,22825,67,35,32
197000,878000,22826,68,31,37
205000,878000,22827,71,50,21
213000,878000,22828,62,35,27
221000,878000,22829,59,34,25
229000,878000,22830,59,23,36
237000,878000,22831,63,10,53
245000,878000,22832,70,35,35
253000,878000,22833,69,35,34
261000,878000,22834,73,9,64
269000,878000,22835,65,36,29
277000,878000,22836,75,25,50
285000,878000,22837,67,22,45
293000,878000,22838,78,65,13
301000,878000,22839,69,62,7
309000,878000,22840,68,64,4
317000,878000,22841,61,59,2
325000,878000,22842,67,65,2
333000,878000,22843,47,45,2
341000,878000,22844,45,39,6
349000,878000,22845,50,42,8
357000,878000,22846,56,21,35
365000,878000,22847,57,49,8
373000,878000,22848,64,32,32
381000,878000,22849,68,62,6
389000,878000,22850,61,61,0
397000,878000,22851,73,72,1
405000,878000,22852,68,68,0
413000,878000,22853,74,74,0
421000,878000,22854,72,72,0
429000,878000,22855,68,63,5
437000,878000,22856,62,48,14
445000,878000,22857,62,57,5
453000,878000,22858,66,64,2
461000,878000,22859,46,44,2
469000,878000,22860,63,63,0
477000,878000,22861,72,70,2
485000,878000,22862,63,61,2
493000,878000,22863,59,49,10
501000,878000,22864,54,54,0
509000,878000,22865,62,59,3
517000,878000,22866,66,56,10
525000,878000,22867,68,66,2
533000,878000,22868,73,70,3
541000,878000,22869,70,67,3
549000,878000,22870,65,63,2
557000,878000,22871,60,57,3
565000,878000,22872,60,58,2
573000,878000,22873,67,66,1
581000,878000,22874,69,69,0
589000,878000,22875,73,73,0
597000,878000,22876,66,66,0
605000,878000,22877,62,62,0
613000,878000,22878,58,58,0
621000,878000,22879,70,69,1
629000,878000,22880,66,66,0
637000,878000,22881,71,71,0
645000,878000,22882,74,74,0
653000,878000,22883,74,74,0
661000,878000,22884,33,33,0
765000,878000,22897,58,58,0
773000,878000,22898,66,66,0
781000,878000,22899,64,64,0
789000,878000,22900,68,68,0
797000,878000,22901,70,70,0
805000,878000,22902,66,65,1
813000,878000,22903,58,58,0
821000,878000,22904,65,65,0
829000,878000,22905,72,72,0
837000,878000,22906,73,73,0
845000,878000,22907,71,71,0
853000,878000,22908,72,72,0
861000,878000,22909,72,72,0
869000,878000,22910,71,71,0
877000,878000,22911,65,65,0
885000,878000,22912,39,39,0
893000,878000,22913,63,63,0
901000,878000,22914,72,72,0
909000,878000,22915,72,72,0
917000,878000,22916,64,64,0
925000,878000,22917,62,62,0
933000,878000,22918,72,72,0
941000,878000,22919,73,73,0
949000,878000,22920,49,49,0
957000,878000,22921,13,13,0
965000,878000,22922,14,14,0
973000,878000,22923,5,5,0
981000,878000,22924,61,61,0
989000,878000,22925,50,50,0
997000,878000,22926,10,10,0
-59000,870000,23090,49,0,49
-51000,870000,23091,74,0,74
-43000,870000,23092,73,0,73
-35000,870000,23093,71,1,70
-27000,870000,23094,80,0,80
-19000,870000,23095,76,0,76
-11000,870000,23096,74,0,74
-3000,870000,23097,64,0,64
5000,870000,23098,74,0,74
13000,870000,23099,72,0,72
21000,870000,23100,78,0,78
29000,870000,23101,67,0,67
37000,870000,23102,47,0,47
45000,870000,23103,63,0,63
53000,870000,23104,66,2,64
61000,870000,23105,67,0,67
69000,870000,23106,72,0,72
77000,870000,23107,68,1,67
85000,870000,23108,69,0,69
93000,870000,23109,67,0,67
101000,870000,23110,66,0,66
109000,870000,23111,76,0,76
117000,870000,23112,70,0,70
125000,870000,23113,56,10,46
133000,870000,23114,55,2,53
141000,870000,23115,63,14,49
149000,870000,23116,67,3,64
157000,870000,23117,72,3,69
165000,870000,23118,69,2,67
173000,870000,23119,72,2,70
181000,870000,23120,70,8,62
189000,870000,23121,73,13,60
197000,870000,23122,70,22,48
205000,870000,23123,68,54,14
213000,870000,23124,62,47,15
221000,870000,23125,71,1,70
229000,870000,23126,68,2,66
237000,870000,23127,75,0,75
245000,870000,23128,74,23,51
253000,870000,23129,70,15,55
261000,870000,23130,67,29,38
269000,870000,23131,61,30,31
277000,870000,23132,68,28,40
285000,870000,23133,70,36,34
293000,870000,23134,64,23,41
301000,870000,23135,70,63,7
309000,870000,23136,69,62,7
317000,870000,23137,71,68,3
325000,870000,23138,56,45,11
333000,870000,23139,63,61,2
341000,870000,23140,58,51,7
349000,870000,23141,55,49,6
357000,870000,23142,65,64,1
365000,870000,23143,51,51,0
373000,870000,23144,69,60,9
381000,870000,23145,71,69,2
389000,870000,23146,65,65,0
397000,870000,23147,70,70,0
405000,870000,23148,69,69,0
413000,870000,23149,69,69,0
421000,870000,23150,71,71,0
429000,870000,23151,69,67,2
437000,870000,23152,69,68,1
445000,870000,23153,71,71,0
453000,870000,23154,74,70,4
461000,870000,23155,72,71,1
469000,870000,23156,73,72,1
477000,870000,23157,65,65,0
485000,870000,23158,72,72,0
493000,870000,23159,73,73,0
501000,870000,23160,67,63,4
509000,870000,23161,77,56,21
517000,870000,23162,72,71,1
525000,870000,23163,67,66,1
533000,870000,23164,66,64,2
541000,870000,23165,78,74,4
549000,870000,23166,64,55,9
557000,870000,23167,65,62,3
565000,870000,23168,74,72,2
573000,870000,23169,71,69,2
581000,870000,23170,69,68,1
589000,870000,23171,64,64,0
597000,870000,23172,34,32,2
605000,870000,23173,61,61,0
613000,870000,23174,66,66,0
621000,870000,23175,72,72,0
629000,870000,23176,60,60,0
637000,870000,23177,71,71,0
645000,870000,23178,73,73,0
653000,870000,23179,74,74,0
661000,870000,23180,11,11,0
757000,870000,23192,9,9,0
765000,870000,23193,55,55,0
773000,870000,23194,59,59,0
781000,870000,23195,60,60,0
789000,870000,23196,68,68,0
797000,870000,23197,67,67,0
805000,870000,23198,66,66,0
813000,870000,23199,67,67,0
821000,870000,23200,67,67,0
829000,870000,23201,72,72,0
837000,870000,23202,71,71,0
845000,870000,23203,73,73,0
853000,870000,23204,72,72,0
861000,870000,23205,71,71,0
869000,870000,23206,69,69,0
877000,870000,23207,55,55,0
885000,870000,23208,58,58,0
893000,870000,23209,73,73,0
901000,870000,23210,64,64,0
909000,870000,23211,66,66,0
917000,870000,23212,61,61,0
925000,870000,23213,62,62,0
933000,870000,23214,71,71,0
941000,870000,23215,65,65,0
949000,870000,23216,68,68,0
957000,870000,23217,53,53,0
965000,870000,23218,59,59,0
973000,870000,23219,60,60,0
981000,870000,23220,68,68,0
989000,870000,23221,58,58,0
997000,870000,23222,2,2,0
-59000,862000,23386,59,0,59
-51000,862000,23387,76,0,76
-43000,862000,23388,73,2,71
-35000,862000,23389,74,0,74
-27000,862000,23390,75,0,75
-19000,862000,23391,74,0,74
-11000,862000,23392,74,0,74
-3000,862000,23393,68,0,68
5000,862000,23394,63,0,63
13000,862000,23395,71,0,71
21000,862000,23396,78,0,78
29000,862000,23397,67,0,67
37000,862000,23398,61,0,61
45000,862000,23399,69,0,69
53000,862000,23400,72,4,68
61000,862000,23401,71,0,71
69000,862000,23402,75,0,75
77000,862000,23403,71,0,71
85000,862000,23404,71,0,71
93000,862000,23405,64,0,64
101000,862000,23406,57,0,57
109000,862000,23407,66,1,65
117000,862000,23408,74,2,72
125000,862000,23409,71,11,60
133000,862000,23410,57,3,54
141000,862000,23411,63,0,63
149000,862000,23412,52,0,52
157000,862000,23413,69,3,66
165000,862000,23414,79,0,79
173000,862000,23415,68,3,65
181000,862000,23416,76,0,76
189000,862000,23417,65,25,40
197000,862000,23418,65,28,37
205000,862000,23419,65,61,4
213000,862000,23420,61,25,36
221000,862000,23421,76,9,67
229000,862000,23422,70,1,69
237000,862000,23423,74,2,72
245000,862000,23424,76,29,47
253000,862000,23425,62,33,29
261000,862000,23426,66,28,38
269000,862000,23427,70,26,44
277000,862000,23428,72,50,22
285000,862000,23429,72,13,59
293000,862000,23430,70,30,40
301000,862000,23431,65,40,25
309000,862000,23432,69,22,47
317000,862000,23433,72,67,5
325000,862000,23434,74,72,2
333000,862000,23435,62,55,7
341000,862000,23436,63,44,19
349000,862000,23437,66,44,22
357000,862000,23438,66,58,8
365000,862000,23439,68,66,2
373000,862000,23440,71,66,5
381000,862000,23441,71,71,0
389000,862000,23442,72,72,0
397000,862000,23443,73,73,0
405000,862000,23444,73,73,0
413000,862000,23445,76,76,0
421000,862000,23446,71,71,0
429000,862000,23447,67,67,0
437000,862000,23448,75,74,1
445000,862000,23449,72,71,1
453000,862000,23450,74,74,0
461000,862000,23451,72,70,2
469000,862000,23452,69,69,0
477000,862000,23453,74,74,0
485000,862000,23454,74,74,0
493000,862000,23455,73,73,0
501000,862000,23456,73,73,0
509000,862000,23457,65,35,30
517000,862000,23458,71,57,14
525000,862000,23459,70,69,1
533000,862000,23460,66,64,2
541000,862000,23461,71,71,0
549000,862000,23462,67,67,0
557000,862000,23463,51,38,13
565000,862000,23464,71,57,14
573000,862000,23465,72,56,16
581000,862000,23466,64,64,0
589000,862000,23467,47,47,0
597000,862000,23468,70,70,0
605000,862000,23469,73,73,0
613000,862000,23470,72,72,0
621000,862000,23471,69,69,0
629000,862000,23472,66,66,0
637000,862000,23473,68,68,0
645000,862000,23474,70,70,0
653000,862000,23475,71,71,0
661000,862000,23476,21,21,0
757000,862000,23488,34,34,0
765000,862000,23489,65,65,0
773000,862000,23490,63,63,0
781000,862000,23491,62,62,0
789000,862000,23492,67,67,0
797000,862000,23493,70,70,0
805000,862000,23494,72,72,0
813000,862000,23495,68,68,0
821000,862000,23496,69,69,0
829000,862000,23497,72,72,0
837000,862000,23498,58,58,0
845000,862000,23499,61,61,0
853000,862000,23500,67,67,0
861000,862000,23501,74,74,0
869000,862000,23502,61,61,0
877000,862000,23503,54,54,0
885000,862000,23504,26,26,0
893000,862000,23505,65,65,0
901000,862000,23506,73,73,0
909000,862000,23507,74,74,0
917000,862000,23508,58,58,0
925000,862000,23509,49,49,0
933000,862000,23510,63,63,0
941000,862000,23511,64,64,0
949000,862000,23512,69,69,0
957000,862000,23513,68,68,0
965000,862000,23514,52,52,0
973000,862000,23515,65,65,0
981000,862000,23516,58,58,0
989000,862000,23517,37,37,0
-59000,854000,23682,8,0,8
-51000,854000,23683,19,0,19
-43000,854000,23684,31,1,30
-35000,854000,23685,44,0,44
-27000,854000,23686,60,0,60
-19000,854000,23687,69,0,69
-11000,854000,23688,74,0,74
-3000,854000,23689,72,0,72
5000,854000,23690,64,0,64
13000,854000,23691,64,0,64
21000,854000,23692,68,0,68
29000,854000,23693,69,0,69
37000,854000,23694,72,0,72
45000,854000,23695,69,0,69
53000,854000,23696,71,3,68
61000,854000,23697,72,1,71
69000,854000,23698,77,0,77
77000,854000,23699,63,0,63
85000,854000,23700,66,1,65
93000,854000,23701,62,0,62
101000,854000,23702,59,0,59
109000,854000,23703,62,0,62
117000,854000,23704,75,0,75
125000,854000,23705,73,15,58
133000,854000,23706,69,0,69
141000,854000,23707,56,0,56
149000,854000,23708,67,0,67
157000,854000,23709,69,1,68
165000,854000,23710,75,0,75
173000,854000,23711,58,4,54
181000,854000,23712,61,11,50
189000,854000,23713,56,38,18
197000,854000,23714,51,35,16
205000,854000,23715,67,39,28
213000,854000,23716,64,26,38
221000,854000,23717,77,44,33
229000,854000,23718,82,4,78
237000,854000,23719,88,0,88
245000,854000,23720,88,19,69
253000,854000,23721,82,38,44
261000,854000,23722,75,25,50
269000,854000,23723,71,42,29
277000,854000,23724,70,53,17
285000,854000,23725,62,48,14
293000,854000,23726,70,30,40
301000,854000,23727,71,24,47
309000,854000,23728,68,55,13
317000,854000,23729,74,70,4
325000,854000,23730,72,72,0
333000,854000,23731,75,75,0
341000,854000,23732,75,75,0
349000,854000,23733,58,58,0
357000,854000,23734,65,56,9
365000,854000,23735,70,64,6
373000,854000,23736,71,69,2
381000,854000,23737,73,73,0
389000,854000,23738,70,70,0
397000,854000,23739,72,71,1
405000,854000,23740,69,69,0
413000,854000,23741,69,68,1
421000,854000,23742,68,67,1
429000,854000,23743,68,68,0
437000,854000,23744,70,70,0
445000,854000,23745,67,63,4
453000,854000,23746,72,67,5
461000,854000,23747,68,65,3
469000,854000,23748,74,74,0
477000,854000,23749,74,74,0
485000,854000,23750,75,75,0
493000,854000,23751,77,65,12
501000,854000,23752,76,76,0
509000,854000,23753,77,77,0
517000,854000,23754,70,70,0
525000,854000,23755,65,65,0
533000,854000,23756,68,67,1
541000,854000,23757,62,61,1
549000,854000,23758,39,30,9
557000,854000,23759,43,43,0
565000,854000,23760,50,45,5
573000,854000,23761,68,68,0
581000,854000,23762,67,67,0
589000,854000,23763,4,4,0
597000,854000,23764,35,35,0
605000,854000,23765,66,66,0
613000,854000,23766,68,65,3
621000,854000,23767,74,74,0
629000,854000,23768,70,70,0
637000,854000,23769,73,73,0
645000,854000,23770,76,76,0
653000,854000,23771,66,65,1
661000,854000,23772,16,16,0
749000,854000,23783,19,19,0
757000,854000,23784,63,63,0
765000,854000,23785,67,67,0
773000,854000,23786,69,69,0
781000,854000,23787,65,65,0
789000,854000,23788,67,67,0
797000,854000,23789,72,72,0
805000,854000,23790,66,66,0
813000,854000,23791,69,69,0
821000,854000,23792,58,58,0
829000,854000,23793,68,68,0
837000,854000,23794,65,65,0
845000,854000,23795,69,69,0
853000,854000,23796,74,74,0
861000,854000,23797,70,70,0
869000,854000,23798,71,71,0
877000,854000,23799,74,74,0
885000,854000,23800,68,68,0
893000,854000,23801,67,67,0
901000,854000,23802,69,69,0
909000,854000,23803,65,65,0
917000,854000,23804,58,58,0
925000,854000,23805,49,49,0
933000,854000,23806,57,57,0
941000,854000,23807,59,59,0
949000,854000,23808,69,69,0
957000,854000,23809,54,54,0
965000,854000,23810,68,68,0
973000,854000,23811,64,64,0
981000,854000,23812,11,11,0
989000,854000,23813,2,2,0
-19000,846000,23983,2,0,2
-11000,846000,23984,10,0,10
-3000,846000,23985,21,0,21
5000,846000,23986,34,0,34
13000,846000,23987,35,0,35
21000,846000,23988,42,0,42
29000,846000,23989,60,0,60
37000,846000,23990,65,1,64
45000,846000,23991,62,0,62
53000,846000,23992,70,0,70
61000,846000,23993,74,2,72
69000,846000,23994,75,0,75
77000,846000,23995,65,0,65
85000,846000,23996,57,0,57
93000,846000,23997,56,1,55
101000,846000,23998,56,3,53
109000,846000,23999,62,0,62
117000,846000,24000,59,0,59
125000,846000,24001,67,8,59
133000,846000,24002,67,4,63
141000,846000,24003,58,0,58
149000,846000,24004,57,0,57
157000,846000,24005,54,2,52
165000,846000,24006,72,0,72
173000,846000,24007,61,4,57
181000,846000,24008,61,45,16
189000,846000,24009,64,34,30
197000,846000,24010,45,31,14
205000,846000,24011,37,37,0
213000,846000,24012,72,59,13
221000,846000,24013,66,40,26
229000,846000,24014,72,18,54
237000,846000,24015,72,1,71
245000,846000,24016,72,8,64
253000,846000,24017,75,7,68
261000,846000,24018,84,11,73
269000,846000,24019,80,27,53
277000,846000,24020,88,69,19
285000,846000,24021,79,40,39
293000,846000,24022,74,39,35
301000,846000,24023,78,15,63
309000,846000,24024,72,57,15
317000,846000,24025,70,68,2
325000,846000,24026,69,66,3
333000,846000,24027,65,65,0
341000,846000,24028,73,72,1
349000,846000,24029,72,71,1
357000,846000,24030,62,48,14
365000,846000,24031,66,62,4
373000,846000,24032,68,59,9
381000,846000,24033,67,63,4
389000,846000,24034,68,68,0
397000,846000,24035,69,66,3
405000,846000,24036,68,68,0
413000,846000,24037,75,74,1
421000,846000,24038,67,67,0
429000,846000,24039,70,70,0
437000,846000,24040,71,71,0
445000,846000,24041,73,70,3
453000,846000,24042,72,67,5
461000,846000,24043,72,70,2
469000,846000,24044,71,71,0
477000,846000,24045,74,73,1
485000,846000,24046,72,72,0
493000,846000,24047,74,72,2
501000,846000,24048,72,72,0
509000,846000,24049,72,72,0
517000,846000,24050,71,67,4
525000,846000,24051,68,66,2
533000,846000,24052,64,61,3
541000,846000,24053,66,64,2
549000,846000,24054,58,57,1
557000,846000,24055,60,58,2
565000,846000,24056,57,43,14
573000,846000,24057,52,45,7
581000,846000,24058,16,16,0
605000,846000,24061,68,68,0
613000,846000,24062,74,70,4
621000,846000,24063,73,72,1
629000,846000,24064,66,66,0
637000,846000,24065,68,67,1
645000,846000,24066,65,65,0
653000,846000,24067,8,8,0
749000,846000,24079,46,46,0
757000,846000,24080,70,70,0
765000,846000,24081,56,56,0
773000,846000,24082,67,67,0
781000,846000,24083,65,65,0
789000,846000,24084,65,65,0
797000,846000,24085,53,53,0
805000,846000,24086,67,67,0
813000,846000,24087,66,66,0
821000,846000,24088,58,58,0
829000,846000,24089,70,70,0
837000,846000,24090,63,63,0
845000,846000,24091,66,66,0
853000,846000,24092,58,58,0
861000,846000,24093,45,45,0
869000,846000,24094,54,54,0
877000,846000,24095,55,55,0
885000,846000,24096,55,55,0
893000,846000,24097,58,58,0
901000,846000,24098,54,54,0
909000,846000,24099,53,53,0
917000,846000,24100,41,41,0
925000,846000,24101,43,43,0
933000,846000,24102,52,52,0
941000,846000,24103,47,47,0
949000,846000,24104,66,66,0
957000,846000,24105,65,65,0
965000,846000,24106,64,64,0
973000,846000,24107,41,41,0
37000,838000,24286,4,0,4
45000,838000,24287,11,1,10
53000,838000,24288,25,0,25
61000,838000,24289,35,0,35
69000,838000,24290,45,0,45
77000,838000,24291,54,0,54
85000,838000,24292,46,2,44
93000,838000,24293,48,0,48
101000,838000,24294,61,1,60
109000,838000,24295,60,3,57
117000,838000,24296,66,0,66
125000,838000,24297,62,8,54
133000,838000,24298,68,4,64
141000,838000,24299,64,3,61
149000,838000,24300,65,2,63
157000,838000,24301,70,0,70
165000,838000,24302,71,0,71
173000,838000,24303,66,4,62
181000,838000,24304,63,44,19
189000,838000,24305,54,46,8
197000,838000,24306,61,28,33
205000,838000,24307,60,55,5
213000,838000,24308,73,56,17
221000,838000,24309,72,67,5
229000,838000,24310,68,12,56
237000,838000,24311,73,10,63
245000,838000,24312,75,0,75
253000,838000,24313,72,27,45
261000,838000,24314,75,54,21
269000,838000,24315,73,57,16
277000,838000,24316,75,43,32
285000,838000,24317,70,43,27
293000,838000,24318,74,51,23
301000,838000,24319,74,57,17
309000,838000,24320,67,59,8
317000,838000,24321,64,53,11
325000,838000,24322,71,64,7
333000,838000,24323,68,65,3
341000,838000,24324,68,66,2
349000,838000,24325,73,73,0
357000,838000,24326,55,38,17
365000,838000,24327,63,57,6
373000,838000,24328,56,43,13
381000,838000,24329,63,63,0
389000,838000,24330,69,67,2
397000,838000,24331,68,68,0
405000,838000,24332,72,72,0
413000,838000,24333,71,70,1
421000,838000,24334,71,69,2
429000,838000,24335,68,68,0
437000,838000,24336,75,75,0
445000,838000,24337,71,71,0
453000,838000,24338,78,75,3
461000,838000,24339,74,74,0
469000,838000,24340,71,71,0
477000,838000,24341,75,74,1
485000,838000,24342,72,72,0
493000,838000,24343,80,80,0
501000,838000,24344,74,73,1
509000,838000,24345,70,69,1
517000,838000,24346,73,72,1
525000,838000,24347,65,61,4
533000,838000,24348,54,52,2
541000,838000,24349,66,62,4
549000,838000,24350,63,59,4
557000,838000,24351,61,49,12
565000,838000,24352,73,72,1
573000,838000,24353,71,71,0
581000,838000,24354,5,5,0
605000,838000,24357,48,48,0
613000,838000,24358,72,67,5
621000,838000,24359,69,69,0
629000,838000,24360,71,71,0
637000,838000,24361,72,72,0
645000,838000,24362,42,42,0
741000,838000,24374,18,18,0
749000,838000,24375,62,62,0
757000,838000,24376,63,63,0
765000,838000,24377,67,67,0
773000,838000,24378,59,59,0
781000,838000,24379,61,61,0
789000,838000,24380,74,74,0
797000,838000,24381,63,62,1
805000,838000,24382,68,68,0
813000,838000,24383,71,71,0
821000,838000,24384,70,70,0
829000,838000,24385,65,65,0
837000,838000,24386,69,69,0
845000,838000,24387,75,75,0
853000,838000,24388,42,42,0
93000,830000,24589,4,0,4
101000,830000,24590,7,0,7
109000,830000,24591,14,0,14
117000,830000,24592,31,0,31
125000,830000,24593,37,0,37
133000,830000,24594,52,0,52
141000,830000,24595,69,0,69
149000,830000,24596,71,0,71
157000,830000,24597,68,0,68
165000,830000,24598,73,2,71
173000,830000,24599,59,4,55
181000,830000,24600,55,51,4
189000,830000,24601,54,45,9
197000,830000,24602,74,14,60
205000,830000,24603,67,46,21
213000,830000,24604,71,6,65
221000,830000,24605,65,41,24
229000,830000,24606,66,15,51
237000,830000,24607,72,0,72
245000,830000,24608,74,0,74
253000,830000,24609,74,0,74
261000,830000,24610,81,8,73
269000,830000,24611,72,32,40
277000,830000,24612,70,51,19
285000,830000,24613,70,39,31
293000,830000,24614,70,34,36
301000,830000,24615,70,38,32
309000,830000,24616,66,39,27
317000,830000,24617,69,58,11
325000,830000,24618,63,62,1
333000,830000,24619,68,60,8
341000,830000,24620,66,45,21
349000,830000,24621,71,58,13
357000,830000,24622,59,50,9
365000,830000,24623,66,55,11
373000,830000,24624,65,61,4
381000,830000,24625,65,52,13
389000,830000,24626,59,59,0
397000,830000,24627,60,60,0
405000,830000,24628,60,55,5
413000,830000,24629,73,72,1
421000,830000,24630,68,67,1
429000,830000,24631,73,73,0
437000,830000,24632,71,71,0
445000,830000,24633,72,72,0
453000,830000,24634,74,74,0
461000,830000,24635,74,73,1
469000,830000,24636,70,70,0
477000,830000,24637,74,74,0
485000,830000,24638,71,71,0
493000,830000,24639,86,86,0
501000,830000,24640,75,75,0
509000,830000,24641,71,67,4
517000,830000,24642,68,65,3
525000,830000,24643,69,66,3
533000,830000,24644,61,43,18
541000,830000,24645,67,56,11
549000,830000,24646,70,55,15
557000,830000,24647,56,40,16
565000,830000,24648,68,62,6
573000,830000,24649,71,71,0
581000,830000,24650,40,40,0
589000,830000,24651,5,4,1
597000,830000,24652,46,43,3
605000,830000,24653,48,48,0
613000,830000,24654,71,70,1
621000,830000,24655,61,61,0
629000,830000,24656,70,70,0
637000,830000,24657,73,73,0
645000,830000,24658,15,15,0
741000,830000,24670,23,23,0
749000,830000,24671,65,65,0
757000,830000,24672,68,68,0
765000,830000,24673,69,69,0
773000,830000,24674,63,63,0
781000,830000,24675,65,65,0
789000,830000,24676,59,59,0
797000,830000,24677,63,63,0
805000,830000,24678,74,74,0
813000,830000,24679,71,71,0
821000,830000,24680,71,71,0
829000,830000,24681,68,68,0
837000,830000,24682,59,59,0
845000,830000,24683,73,73,0
853000,830000,24684,35,35,0
149000,822000,24892,7,0,7
157000,822000,24893,16,0,16
165000,822000,24894,24,0,24
173000,822000,24895,28,14,14
181000,822000,24896,39,38,1
189000,822000,24897,37,29,8
197000,822000,24898,62,4,58
205000,822000,24899,71,14,57
213000,822000,24900,69,19,50
221000,822000,24901,71,10,61
229000,822000,24902,74,1,73
237000,822000,24903,74,29,45
245000,822000,24904,74,4,70
253000,822000,24905,74,2,72
261000,822000,24906,80,9,71
269000,822000,24907,70,27,43
277000,822000,24908,71,56,15
285000,822000,24909,70,65,5
293000,822000,24910,68,42,26
301000,822000,24911,72,15,57
309000,822000,24912,67,48,19
317000,822000,24913,71,46,25
325000,822000,24914,66,54,12
333000,822000,24915,71,50,21
341000,822000,24916,69,54,15
349000,822000,24917,75,73,2
357000,822000,24918,51,51,0
365000,822000,24919,62,58,4
373000,822000,24920,63,47,16
381000,822000,24921,61,52,9
389000,822000,24922,64,63,1
397000,822000,24923,68,68,0
405000,822000,24924,69,68,1
413000,822000,24925,72,72,0
421000,822000,24926,73,73,0
429000,822000,24927,69,69,0
437000,822000,24928,70,69,1
445000,822000,24929,72,72,0
453000,822000,24930,72,72,0
461000,822000,24931,73,73,0
469000,822000,24932,73,71,2
477000,822000,24933,72,72,0
485000,822000,24934,75,75,0
493000,822000,24935,74,74,0
501000,822000,24936,73,73,0
509000,822000,24937,67,67,0
517000,822000,24938,68,62,6
525000,822000,24939,65,63,2
533000,822000,24940,59,58,1
541000,822000,24941,50,46,4
549000,822000,24942,70,28,42
557000,822000,24943,72,50,22
565000,822000,24944,72,70,2
573000,822000,24945,74,63,11
581000,822000,24946,42,42,0
589000,822000,24947,38,38,0
597000,822000,24948,66,61,5
605000,822000,24949,67,64,3
613000,822000,24950,65,57,8
621000,822000,24951,65,65,0
629000,822000,24952,71,71,0
637000,822000,24953,67,67,0
741000,822000,24966,9,9,0
749000,822000,24967,55,55,0
757000,822000,24968,59,59,0
765000,822000,24969,64,64,0
773000,822000,24970,69,69,0
781000,822000,24971,70,70,0
789000,822000,24972,70,70,0
797000,822000,24973,62,62,0
805000,822000,24974,72,72,0
813000,822000,24975,69,69,0
821000,822000,24976,72,72,0
829000,822000,24977,69,69,0
837000,822000,24978,74,74,0
845000,822000,24979,75,75,0
853000,822000,24980,34,34,0
213000,814000,25196,10,2,8
221000,814000,25197,16,2,14
229000,814000,25198,26,0,26
237000,814000,25199,28,3,25
245000,814000,25200,36,0,36
253000,814000,25201,41,23,18
261000,814000,25202,53,8,45
269000,814000,25203,64,2,62
277000,814000,25204,68,29,39
285000,814000,25205,72,46,26
293000,814000,25206,65,52,13
301000,814000,25207,71,55,16
309000,814000,25208,67,30,37
317000,814000,25209,76,32,44
325000,814000,25210,73,39,34
333000,814000,25211,71,25,46
341000,814000,25212,66,50,16
349000,814000,25213,75,70,5
357000,814000,25214,51,50,1
365000,814000,25215,67,63,4
373000,814000,25216,66,63,3
381000,814000,25217,65,53,12
389000,814000,25218,68,53,15
397000,814000,25219,75,75,0
405000,814000,25220,79,79,0
413000,814000,25221,75,75,0
421000,814000,25222,76,76,0
429000,814000,25223,80,80,0
437000,814000,25224,75,75,0
445000,814000,25225,75,75,0
453000,814000,25226,74,74,0
461000,814000,25227,70,70,0
469000,814000,25228,64,64,0
477000,814000,25229,69,67,2
485000,814000,25230,70,70,0
493000,814000,25231,76,74,2
501000,814000,25232,60,53,7
509000,814000,25233,72,61,11
517000,814000,25234,54,28,26
525000,814000,25235,53,41,12
533000,814000,25236,64,47,17
541000,814000,25237,72,40,32
549000,814000,25238,72,51,21
557000,814000,25239,70,65,5
565000,814000,25240,71,67,4
573000,814000,25241,65,59,6
581000,814000,25242,58,42,16
589000,814000,25243,63,56,7
597000,814000,25244,65,64,1
605000,814000,25245,72,71,1
613000,814000,25246,72,71,1
621000,814000,25247,70,69,1
629000,814000,25248,72,70,2
637000,814000,25249,64,64,0
645000,814000,25250,1,1,0
741000,814000,25262,7,7,0
749000,814000,25263,63,63,0
757000,814000,25264,62,62,0
765000,814000,25265,64,64,0
773000,814000,25266,61,61,0
781000,814000,25267,66,66,0
789000,814000,25268,68,68,0
797000,814000,25269,68,68,0
805000,814000,25270,76,76,0
813000,814000,25271,76,76,0
821000,814000,25272,75,75,0
829000,814000,25273,74,74,0
837000,814000,25274,68,68,0
845000,814000,25275,73,73,0
853000,814000,25276,37,37,0
277000,806000,25500,1,0,1
285000,806000,25501,3,3,0
293000,806000,25502,13,11,2
301000,806000,25503,19,15,4
309000,806000,25504,30,16,14
317000,806000,25505,43,10,33
325000,806000,25506,44,24,20
333000,806000,25507,51,23,28
341000,806000,25508,58,37,21
349000,806000,25509,66,60,6
357000,806000,25510,59,58,1
365000,806000,25511,62,60,2
373000,806000,25512,46,40,6
381000,806000,25513,68,38,30
389000,806000,25514,69,65,4
397000,806000,25515,77,76,1
405000,806000,25516,76,76,0
413000,806000,25517,72,72,0
421000,806000,25518,72,72,0
429000,806000,25519,66,66,0
437000,806000,25520,70,70,0
445000,806000,25521,70,70,0
453000,806000,25522,70,70,0
461000,806000,25523,65,65,0
469000,806000,25524,71,71,0
477000,806000,25525,73,69,4
485000,806000,25526,68,67,1
493000,806000,25527,68,67,1
501000,806000,25528,68,65,3
509000,806000,25529,69,65,4
517000,806000,25530,67,59,8
525000,806000,25531,72,69,3
533000,806000,25532,71,55,16
541000,806000,25533,68,30,38
549000,806000,25534,72,53,19
557000,806000,25535,59,52,7
565000,806000,25536,64,60,4
573000,806000,25537,61,50,11
581000,806000,25538,63,51,12
589000,806000,25539,71,71,0
597000,806000,25540,74,73,1
605000,806000,25541,73,73,0
613000,806000,25542,78,78,0
621000,806000,25543,73,73,0
629000,806000,25544,72,71,1
637000,806000,25545,71,71,0
645000,806000,25546,4,4,0
741000,806000,25558,12,12,0
749000,806000,25559,66,66,0
757000,806000,25560,66,66,0
765000,806000,25561,63,63,0
773000,806000,25562,67,67,0
781000,806000,25563,68,68,0
789000,806000,25564,67,67,0
797000,806000,25565,74,74,0
805000,806000,25566,73,73,0
813000,806000,25567,74,74,0
821000,806000,25568,72,72,0
829000,806000,25569,69,69,0
837000,806000,25570,76,76,0
845000,806000,25571,74,74,0
853000,806000,25572,32,32,0
357000,798000,25806,35,35,0
365000,798000,25807,76,75,1
373000,798000,25808,58,42,16
381000,798000,25809,57,37,20
389000,798000,25810,62,57,5
397000,798000,25811,71,67,4
405000,798000,25812,67,67,0
413000,798000,25813,72,71,1
421000,798000,25814,72,72,0
429000,798000,25815,75,75,0
437000,798000,25816,70,69,1
445000,798000,25817,74,73,1
453000,798000,25818,56,56,0
461000,798000,25819,63,63,0
469000,798000,25820,69,69,0
477000,798000,25821,71,69,2
485000,798000,25822,59,56,3
493000,798000,25823,62,56,6
501000,798000,25824,59,55,4
509000,798000,25825,64,63,1
517000,798000,25826,65,62,3
525000,798000,25827,72,58,14
533000,798000,25828,64,37,27
541000,798000,25829,57,29,28
549000,798000,25830,68,43,25
557000,798000,25831,63,57,6
565000,798000,25832,66,36,30
573000,798000,25833,68,68,0
581000,798000,25834,66,66,0
589000,798000,25835,68,68,0
597000,798000,25836,75,73,2
605000,798000,25837,69,69,0
613000,798000,25838,73,73,0
621000,798000,25839,73,73,0
629000,798000,25840,77,77,0
637000,798000,25841,60,60,0
741000,798000,25854,61,61,0
749000,798000,25855,64,64,0
757000,798000,25856,68,68,0
765000,798000,25857,66,66,0
773000,798000,25858,68,68,0
781000,798000,25859,73,73,0
789000,798000,25860,66,66,0
797000,798000,25861,73,73,0
805000,798000,25862,73,73,0
813000,798000,25863,75,75,0
821000,798000,25864,65,65,0
829000,798000,25865,54,54,0
837000,798000,25866,59,59,0
845000,798000,25867,73,73,0
853000,798000,25868,29,29,0
357000,790000,26102,27,27,0
365000,790000,26103,69,68,1
373000,790000,26104,74,65,9
381000,790000,26105,63,56,7
389000,790000,26106,65,58,7
397000,790000,26107,72,72,0
405000,790000,26108,73,73,0
413000,790000,26109,71,71,0
421000,790000,26110,63,63,0
429000,790000,26111,75,75,0
437000,790000,26112,69,69,0
445000,790000,26113,75,75,0
453000,790000,26114,62,62,0
461000,790000,26115,67,66,1
469000,790000,26116,69,69,0
477000,790000,26117,76,65,11
485000,790000,26118,65,54,11
493000,790000,26119,61,56,5
501000,790000,26120,52,39,13
509000,790000,26121,64,60,4
517000,790000,26122,56,48,8
525000,790000,26123,56,46,10
533000,790000,26124,65,26,39
541000,790000,26125,67,47,20
549000,790000,26126,74,54,20
557000,790000,26127,62,61,1
565000,790000,26128,67,5,62
573000,790000,26129,67,65,2
581000,790000,26130,72,72,0
589000,790000,26131,77,77,0
597000,790000,26132,74,74,0
605000,790000,26133,73,73,0
613000,790000,26134,70,70,0
621000,790000,26135,71,71,0
629000,790000,26136,67,67,0
637000,790000,26137,20,20,0
733000,790000,26149,16,16,0
741000,790000,26150,68,68,0
749000,790000,26151,72,72,0
757000,790000,26152,66,66,0
765000,790000,26153,65,65,0
773000,790000,26154,67,67,0
781000,790000,26155,70,70,0
789000,790000,26156,73,73,0
797000,790000,26157,71,71,0
805000,790000,26158,72,72,0
813000,790000,26159,64,64,0
821000,790000,26160,61,61,0
829000,790000,26161,59,59,0
837000,790000,26162,69,69,0
845000,790000,26163,62,62,0
853000,790000,26164,27,27,0
357000,782000,26398,6,6,0
365000,782000,26399,36,36,0
373000,782000,26400,64,63,1
381000,782000,26401,62,55,7
389000,782000,26402,71,71,0
397000,782000,26403,72,71,1
405000,782000,26404,78,77,1
413000,782000,26405,71,68,3
421000,782000,26406,72,72,0
429000,782000,26407,59,57,2
437000,782000,26408,57,55,2
445000,782000,26409,61,60,1
453000,782000,26410,65,65,0
461000,782000,26411,73,73,0
469000,782000,26412,65,65,0
477000,782000,26413,68,68,0
485000,782000,26414,72,72,0
493000,782000,26415,58,58,0
501000,782000,26416,64,64,0
509000,782000,26417,74,72,2
517000,782000,26418,69,66,3
525000,782000,26419,68,64,4
533000,782000,26420,63,58,5
541000,782000,26421,64,51,13
549000,782000,26422,70,49,21
557000,782000,26423,61,39,22
565000,782000,26424,63,34,29
573000,782000,26425,74,74,0
581000,782000,26426,77,76,1
589000,782000,26427,74,73,1
597000,782000,26428,66,66,0
605000,782000,26429,71,71,0
613000,782000,26430,67,67,0
621000,782000,26431,75,75,0
629000,782000,26432,73,72,1
733000,782000,26445,3,3,0
741000,782000,26446,60,60,0
749000,782000,26447,70,70,0
757000,782000,26448,66,66,0
765000,782000,26449,70,70,0
773000,782000,26450,69,69,0
781000,782000,26451,73,73,0
789000,782000,26452,73,73,0
797000,782000,26453,73,73,0
805000,782000,26454,72,71,1
813000,782000,26455,60,60,0
821000,782000,26456,57,57,0
829000,782000,26457,55,55,0
837000,782000,26458,62,62,0
845000,782000,26459,65,65,0
853000,782000,26460,28,28,0
365000,774000,26695,18,18,0
373000,774000,26696,71,71,0
381000,774000,26697,67,59,8
389000,774000,26698,72,72,0
397000,774000,26699,71,71,0
405000,774000,26700,75,75,0
413000,774000,26701,67,67,0
421000,774000,26702,66,65,1
429000,774000,26703,58,57,1
437000,774000,26704,52,49,3
445000,774000,26705,59,58,1
453000,774000,26706,49,49,0
461000,774000,26707,68,67,1
469000,774000,26708,67,61,6
477000,774000,26709,67,47,20
485000,774000,26710,65,60,5
493000,774000,26711,69,52,17
501000,774000,26712,73,40,33
509000,774000,26713,75,46,29
517000,774000,26714,70,43,27
525000,774000,26715,72,40,32
533000,774000,26716,64,54,10
541000,774000,26717,65,61,4
549000,774000,26718,66,60,6
557000,774000,26719,69,67,2
565000,774000,26720,63,62,1
573000,774000,26721,66,66,0
581000,774000,26722,70,70,0
589000,774000,26723,73,73,0
597000,774000,26724,67,67,0
605000,774000,26725,76,76,0
613000,774000,26726,73,73,0
621000,774000,26727,71,71,0
629000,774000,26728,51,51,0
741000,774000,26742,45,45,0
749000,774000,26743,70,70,0
757000,774000,26744,63,63,0
765000,774000,26745,69,69,0
773000,774000,26746,67,67,0
781000,774000,26747,69,68,1
789000,774000,26748,59,59,0
797000,774000,26749,70,70,0
805000,774000,26750,57,57,0
813000,774000,26751,63,63,0
821000,774000,26752,64,64,0
829000,774000,26753,64,64,0
837000,774000,26754,69,69,0
845000,774000,26755,72,72,0
853000,774000,26756,29,29,0
357000,766000,26990,2,2,0
365000,766000,26991,63,63,0
373000,766000,26992,61,60,1
381000,766000,26993,58,52,6
389000,766000,26994,67,67,0
397000,766000,26995,67,67,0
405000,766000,26996,67,64,3
413000,766000,26997,61,61,0
421000,766000,26998,62,62,0
429000,766000,26999,62,62,0
437000,766000,27000,59,52,7
445000,766000,27001,62,62,0
453000,766000,27002,62,62,0
461000,766000,27003,71,71,0
469000,766000,27004,71,48,23
477000,766000,27005,65,56,9
485000,766000,27006,72,58,14
493000,766000,27007,73,40,33
501000,766000,27008,75,10,65
509000,766000,27009,76,22,54
517000,766000,27010,68,31,37
525000,766000,27011,67,65,2
533000,766000,27012,70,68,2
541000,766000,27013,71,68,3
549000,766000,27014,71,66,5
557000,766000,27015,70,68,2
565000,766000,27016,69,57,12
573000,766000,27017,74,74,0
581000,766000,27018,76,76,0
589000,766000,27019,73,73,0
597000,766000,27020,67,67,0
605000,766000,27021,73,72,1
613000,766000,27022,78,77,1
621000,766000,27023,74,74,0
629000,766000,27024,9,9,0
741000,766000,27038,28,28,0
749000,766000,27039,59,59,0
757000,766000,27040,66,66,0
765000,766000,27041,64,64,0
773000,766000,27042,68,68,0
781000,766000,27043,64,64,0
789000,766000,27044,68,68,0
797000,766000,27045,64,64,0
805000,766000,27046,66,66,0
813000,766000,27047,37,37,0
821000,766000,27048,14,14,0
829000,766000,27049,12,12,0
837000,766000,27050,18,18,0
845000,766000,27051,24,24,0
853000,766000,27052,10,10,0
357000,758000,27286,26,21,5
365000,758000,27287,61,61,0
373000,758000,27288,63,63,0
381000,758000,27289,65,64,1
389000,758000,27290,61,60,1
397000,758000,27291,59,52,7
405000,758000,27292,68,68,0
413000,758000,27293,66,62,4
421000,758000,27294,64,62,2
429000,758000,27295,65,64,1
437000,758000,27296,59,37,22
445000,758000,27297,61,34,27
453000,758000,27298,61,47,14
461000,758000,27299,53,53,0
469000,758000,27300,61,44,17
477000,758000,27301,68,65,3
485000,758000,27302,70,65,5
493000,758000,27303,72,31,41
501000,758000,27304,72,39,33
509000,758000,27305,76,41,35
517000,758000,27306,68,36,32
525000,758000,27307,73,66,7
533000,758000,27308,70,66,4
541000,758000,27309,71,63,8
549000,758000,27310,73,64,9
557000,758000,27311,73,70,3
565000,758000,27312,67,64,3
573000,758000,27313,74,70,4
581000,758000,27314,68,68,0
589000,758000,27315,73,73,0
597000,758000,27316,76,76,0
605000,758000,27317,73,73,0
613000,758000,27318,76,76,0
621000,758000,27319,60,60,0
741000,758000,27334,2,2,0
749000,758000,27335,52,52,0
757000,758000,27336,70,70,0
765000,758000,27337,64,64,0
773000,758000,27338,69,69,0
781000,758000,27339,69,69,0
789000,758000,27340,63,63,0
797000,758000,27341,54,54,0
805000,758000,27342,67,67,0
813000,758000,27343,35,35,0
357000,750000,27582,18,13,5
365000,750000,27583,66,66,0
373000,750000,27584,68,67,1
381000,750000,27585,64,64,0
389000,750000,27586,68,67,1
397000,750000,27587,74,74,0
405000,750000,27588,69,68,1
413000,750000,27589,68,68,0
421000,750000,27590,78,77,1
429000,750000,27591,72,72,0
437000,750000,27592,80,80,0
445000,750000,27593,69,68,1
453000,750000,27594,69,68,1
461000,750000,27595,71,69,2
469000,750000,27596,65,59,6
477000,750000,27597,68,58,10
485000,750000,27598,68,66,2
493000,750000,27599,72,37,35
501000,750000,27600,65,54,11
509000,750000,27601,64,43,21
517000,750000,27602,63,52,11
525000,750000,27603,66,61,5
533000,750000,27604,63,57,6
541000,750000,27605,64,40,24
549000,750000,27606,63,58,5
557000,750000,27607,64,62,2
565000,750000,27608,69,61,8
573000,750000,27609,70,69,1
581000,750000,27610,65,65,0
589000,750000,27611,71,71,0
597000,750000,27612,76,76,0
605000,750000,27613,73,72,1
613000,750000,27614,77,77,0
621000,750000,27615,44,42,2
749000,750000,27631,17,17,0
757000,750000,27632,21,21,0
765000,750000,27633,26,26,0
773000,750000,27634,26,26,0
781000,750000,27635,35,35,0
789000,750000,27636,40,40,0
797000,750000,27637,35,35,0
805000,750000,27638,38,38,0
813000,750000,27639,20,20,0
357000,742000,27878,33,33,0
365000,742000,27879,65,65,0
373000,742000,27880,73,61,12
381000,742000,27881,75,70,5
389000,742000,27882,74,69,5
397000,742000,27883,72,56,16
405000,742000,27884,71,60,11
413000,742000,27885,74,74,0
421000,742000,27886,71,60,11
429000,742000,27887,71,70,1
437000,742000,27888,76,76,0
445000,742000,27889,79,79,0
453000,742000,27890,74,74,0
461000,742000,27891,75,75,0
469000,742000,27892,72,72,0
477000,742000,27893,73,63,10
485000,742000,27894,70,64,6
493000,742000,27895,52,50,2
501000,742000,27896,30,29,1
509000,742000,27897,66,63,3
517000,742000,27898,69,59,10
525000,742000,27899,66,57,9
533000,742000,27900,58,54,4
541000,742000,27901,64,55,9
549000,742000,27902,67,64,3
557000,742000,27903,68,67,1
565000,742000,27904,56,50,6
573000,742000,27905,67,67,0
581000,742000,27906,64,64,0
589000,742000,27907,72,72,0
597000,742000,27908,69,69,0
605000,742000,27909,65,64,1
613000,742000,27910,67,67,0
621000,742000,27911,51,51,0
357000,734000,28174,18,17,1
365000,734000,28175,69,59,10
373000,734000,28176,69,29,40
381000,734000,28177,73,70,3
389000,734000,28178,74,47,27
397000,734000,28179,76,61,15
405000,734000,28180,75,70,5
413000,734000,28181,72,35,37
421000,734000,28182,72,15,57
429000,734000,28183,70,39,31
437000,734000,28184,68,42,26
445000,734000,28185,72,52,20
453000,734000,28186,63,50,13
461000,734000,28187,70,38,32
469000,734000,28188,73,54,19
477000,734000,28189,72,62,10
485000,734000,28190,71,55,16
493000,734000,28191,69,52,17
501000,734000,28192,71,64,7
509000,734000,28193,55,51,4
517000,734000,28194,63,47,16
525000,734000,28195,75,50,25
533000,734000,28196,57,49,8
541000,734000,28197,62,54,8
549000,734000,28198,66,66,0
557000,734000,28199,68,68,0
565000,734000,28200,66,61,5
573000,734000,28201,55,52,3
581000,734000,28202,63,61,2
589000,734000,28203,56,52,4
597000,734000,28204,62,60,2
605000,734000,28205,70,68,2
613000,734000,28206,70,70,0
621000,734000,28207,64,64,0
365000,726000,28471,71,31,40
373000,726000,28472,68,19,49
381000,726000,28473,60,55,5
389000,726000,28474,74,71,3
397000,726000,28475,69,67,2
405000,726000,28476,72,72,0
413000,726000,28477,70,33,37
421000,726000,28478,67,49,18
429000,726000,28479,71,67,4
437000,726000,28480,73,57,16
445000,726000,28481,68,50,18
453000,726000,28482,69,60,9
461000,726000,28483,72,67,5
469000,726000,28484,75,53,22
477000,726000,28485,65,53,12
485000,726000,28486,75,70,5
493000,726000,28487,74,74,0
501000,726000,28488,77,71,6
509000,726000,28489,61,53,8
517000,726000,28490,67,48,19
525000,726000,28491,80,51,29
533000,726000,28492,67,64,3
541000,726000,28493,63,62,1
549000,726000,28494,59,50,9
557000,726000,28495,64,64,0
565000,726000,28496,61,49,12
573000,726000,28497,64,61,3
581000,726000,28498,74,74,0
589000,726000,28499,74,69,5
597000,726000,28500,70,68,2
605000,726000,28501,73,72,1
613000,726000,28502,79,79,0
621000,726000,28503,47,45,2
365000,718000,28767,63,59,4
373000,718000,28768,67,62,5
381000,718000,28769,74,74,0
389000,718000,28770,66,55,11
397000,718000,28771,79,79,0
405000,718000,28772,77,77,0
413000,718000,28773,59,50,9
421000,718000,28774,64,47,17
429000,718000,28775,64,61,3
437000,718000,28776,67,51,16
445000,718000,28777,75,30,45
453000,718000,28778,68,52,16
461000,718000,28779,72,62,10
469000,718000,28780,69,39,30
477000,718000,28781,69,61,8
485000,718000,28782,79,56,23
493000,718000,28783,73,66,7
501000,718000,28784,77,71,6
509000,718000,28785,74,62,12
517000,718000,28786,74,68,6
525000,718000,28787,75,66,9
533000,718000,28788,26,22,4
541000,718000,28789,57,45,12
549000,718000,28790,60,54,6
557000,718000,28791,66,46,20
565000,718000,28792,73,70,3
573000,718000,28793,66,55,11
581000,718000,28794,73,72,1
589000,718000,28795,67,55,12
597000,718000,28796,73,73,0
605000,718000,28797,74,73,1
613000,718000,28798,75,75,0
621000,718000,28799,69,69,0
629000,718000,28800,3,3,0
365000,710000,29063,4,4,0
373000,710000,29064,37,37,0
381000,710000,29065,53,53,0
389000,710000,29066,65,65,0
397000,710000,29067,75,75,0
405000,710000,29068,72,70,2
413000,710000,29069,68,9,59
421000,710000,29070,70,11,59
429000,710000,29071,65,53,12
437000,710000,29072,58,55,3
445000,710000,29073,74,43,31
453000,710000,29074,78,64,14
461000,710000,29075,69,61,8
469000,710000,29076,82,71,11
477000,710000,29077,69,65,4
485000,710000,29078,78,60,18
493000,710000,29079,76,69,7
501000,710000,29080,75,32,43
509000,710000,29081,72,52,20
517000,710000,29082,70,45,25
525000,710000,29083,58,57,1
533000,710000,29084,57,53,4
541000,710000,29085,69,68,1
549000,710000,29086,58,57,1
557000,710000,29087,57,54,3
565000,710000,29088,73,73,0
573000,710000,29089,75,71,4
581000,710000,29090,64,63,1
589000,710000,29091,68,65,3
597000,710000,29092,66,64,2
605000,710000,29093,57,56,1
613000,710000,29094,74,68,6
621000,710000,29095,76,76,0
629000,710000,29096,4,4,0
389000,702000,29362,20,20,0
397000,702000,29363,67,67,0
405000,702000,29364,64,58,6
413000,702000,29365,69,19,50
421000,702000,29366,68,36,32
429000,702000,29367,74,5,69
437000,702000,29368,68,45,23
445000,702000,29369,73,55,18
453000,702000,29370,79,48,31
461000,702000,29371,80,73,7
469000,702000,29372,75,71,4
477000,702000,29373,78,36,42
485000,702000,29374,75,23,52
493000,702000,29375,74,59,15
501000,702000,29376,69,66,3
509000,702000,29377,79,28,51
517000,702000,29378,77,49,28
525000,702000,29379,65,53,12
533000,702000,29380,68,51,17
541000,702000,29381,78,78,0
549000,702000,29382,66,61,5
557000,702000,29383,69,60,9
565000,702000,29384,64,56,8
573000,702000,29385,65,57,8
581000,702000,29386,72,72,0
589000,702000,29387,71,70,1
597000,702000,29388,70,64,6
605000,702000,29389,67,61,6
613000,702000,29390,66,45,21
621000,702000,29391,68,51,17
629000,702000,29392,38,38,0
389000,694000,29658,3,3,0
397000,694000,29659,59,43,16
405000,694000,29660,71,10,61
413000,694000,29661,71,13,58
421000,694000,29662,57,49,8
429000,694000,29663,70,10,60
437000,694000,29664,67,22,45
445000,694000,29665,71,58,13
453000,694000,29666,72,61,11
461000,694000,29667,78,67,11
469000,694000,29668,72,72,0
477000,694000,29669,70,34,36
485000,694000,29670,68,29,39
493000,694000,29671,75,50,25
501000,694000,29672,76,62,14
509000,694000,29673,67,34,33
517000,694000,29674,76,36,40
525000,694000,29675,72,34,38
533000,694000,29676,75,3,72
541000,694000,29677,73,11,62
549000,694000,29678,78,24,54
557000,694000,29679,63,52,11
565000,694000,29680,70,56,14
573000,694000,29681,65,61,4
581000,694000,29682,69,65,4
589000,694000,29683,70,63,7
597000,694000,29684,65,60,5
605000,694000,29685,57,45,12
613000,694000,29686,69,13,56
621000,694000,29687,68,11,57
629000,694000,29688,29,27,2
397000,686000,29955,26,26,0
405000,686000,29956,34,23,11
413000,686000,29957,39,7,32
421000,686000,29958,53,46,7
429000,686000,29959,52,21,31
437000,686000,29960,62,19,43
445000,686000,29961,71,20,51
453000,686000,29962,69,35,34
461000,686000,29963,64,47,17
469000,686000,29964,64,57,7
477000,686000,29965,64,46,18
485000,686000,29966,70,16,54
493000,686000,29967,59,33,26
501000,686000,29968,63,47,16
509000,686000,29969,68,46,22
517000,686000,29970,70,44,26
525000,686000,29971,74,19,55
533000,686000,29972,76,13,63
541000,686000,29973,71,18,53
549000,686000,29974,70,32,38
557000,686000,29975,70,57,13
565000,686000,29976,58,51,7
573000,686000,29977,65,59,6
581000,686000,29978,70,70,0
589000,686000,29979,62,62,0
597000,686000,29980,61,58,3
605000,686000,29981,66,41,25
613000,686000,29982,68,41,27
621000,686000,29983,72,33,39
629000,686000,29984,14,13,1
453000,678000,30258,6,1,5
461000,678000,30259,12,6,6
469000,678000,30260,17,8,9
477000,678000,30261,23,21,2
485000,678000,30262,30,2,28
493000,678000,30263,35,21,14
501000,678000,30264,40,18,22
509000,678000,30265,51,46,5
517000,678000,30266,52,36,16
525000,678000,30267,65,17,48
533000,678000,30268,70,55,15
541000,678000,30269,69,39,30
549000,678000,30270,65,64,1
557000,678000,30271,72,48,24
565000,678000,30272,55,53,2
573000,678000,30273,58,49,9
581000,678000,30274,75,73,2
589000,678000,30275,67,66,1
597000,678000,30276,67,65,2
605000,678000,30277,69,52,17
613000,678000,30278,68,43,25
621000,678000,30279,66,24,42
629000,678000,30280,8,7,1
541000,670000,30565,6,6,0
549000,670000,30566,11,11,0
557000,670000,30567,12,5,7
565000,670000,30568,16,16,0
573000,670000,30569,24,11,13
581000,670000,30570,28,23,5
589000,670000,30571,29,29,0
597000,670000,30572,28,24,4
605000,670000,30573,31,28,3
613000,670000,30574,40,30,10
621000,670000,30575,47,45,2
629000,670000,30576,6,2,4
